lsoa,id,Violence and sexual offences,Robbery,personTotal,personRank,personTie,Burglary,Vehicle crime,Bicycle theft,Criminal damage and arson,Other theft,Shoplifting,Theft from the person,propertyTotal,propertyRank,propertyTie
Birmingham 001A,E01009417,3,2,5,1592,Y,6,5,0,0,0,0,0,11,1665,Y
Birmingham 001B,E01009418,11,0,11,1355,Y,12,10,1,4,2,0,0,29,1346,Y
Birmingham 001C,E01009419,4,0,4,1626,Y,9,7,0,1,0,0,0,17,1593,Y
Birmingham 001D,E01009433,6,0,6,1556,Y,12,7,0,10,0,0,0,29,1346,Y
Birmingham 002A,E01009415,5,1,6,1556,Y,6,6,0,3,0,0,1,16,1608,Y
Birmingham 002B,E01009422,28,3,31,655,Y,16,11,3,6,7,15,0,58,635,Y
Birmingham 002C,E01009423,14,2,16,1171,Y,6,7,1,5,6,8,2,35,1190,Y
Birmingham 002D,E01009425,14,2,16,1171,Y,8,2,1,7,18,27,1,64,521,Y
Birmingham 003A,E01009416,23,0,23,927,Y,3,6,1,4,7,0,1,22,1509,Y
Birmingham 003B,E01009420,7,0,7,1518,Y,5,3,0,4,0,0,0,12,1656,Y
Birmingham 003C,E01009426,6,0,6,1556,Y,3,5,0,2,1,0,0,11,1665,Y
Birmingham 003D,E01009429,11,0,11,1355,Y,11,0,1,3,5,2,0,22,1509,Y
Birmingham 003E,E01009431,15,0,15,1217,Y,9,4,1,8,3,1,0,26,1420,Y
Birmingham 004A,E01009421,1,0,1,1685,Y,3,6,0,2,0,0,0,11,1665,Y
Birmingham 004B,E01009424,40,6,46,311,Y,10,9,3,14,17,7,3,63,538,Y
Birmingham 004C,E01009427,3,0,3,1651,Y,9,4,1,3,2,0,0,19,1563,Y
Birmingham 004D,E01009428,2,0,2,1666,Y,6,2,0,3,1,0,0,12,1656,Y
Birmingham 004E,E01009430,11,2,13,1288,Y,11,3,0,10,3,1,0,28,1373,Y
Birmingham 004F,E01009468,9,0,9,1445,Y,9,9,0,1,2,0,0,21,1531,Y
Birmingham 005A,E01009445,34,1,35,554,Y,11,6,0,24,8,0,0,49,830,Y
Birmingham 005B,E01009446,29,0,29,716,Y,11,11,0,12,5,0,1,40,1076,Y
Birmingham 005C,E01009447,18,2,20,1025,Y,5,3,2,15,1,0,1,27,1397,Y
Birmingham 005D,E01009448,26,3,29,716,Y,12,5,0,20,5,0,0,42,1014,Y
Birmingham 005E,E01009452,27,3,30,686,Y,6,2,0,11,3,0,1,23,1483,Y
Birmingham 005F,E01009455,29,1,30,686,Y,3,6,0,9,2,0,0,20,1545,Y
Birmingham 006A,E01009432,32,1,33,596,Y,18,14,2,5,10,1,1,51,782,Y
Birmingham 006B,E01009435,7,1,8,1484,Y,8,2,0,2,2,0,0,14,1634,Y
Birmingham 006C,E01009437,13,1,14,1251,Y,13,9,0,11,3,8,0,44,958,Y
Birmingham 006D,E01009444,11,1,12,1319,Y,7,7,1,6,31,1,1,54,704,Y
Birmingham 006E,E01009454,5,0,5,1592,Y,6,10,4,4,5,10,0,39,1104,Y
Birmingham 007A,E01009221,40,7,47,291,Y,15,9,0,15,5,73,3,120,162,Y
Birmingham 007B,E01009464,15,0,15,1217,Y,10,14,0,4,1,1,0,30,1319,Y
Birmingham 007C,E01009465,7,0,7,1518,Y,6,7,0,5,2,0,0,20,1545,Y
Birmingham 007D,E01009467,10,1,11,1355,Y,13,8,1,4,1,0,0,27,1397,Y
Birmingham 008A,E01009220,13,4,17,1137,Y,7,5,0,8,2,1,0,23,1483,Y
Birmingham 008B,E01009222,31,0,31,655,Y,13,12,1,14,4,0,1,45,929,Y
Birmingham 008C,E01009224,17,2,19,1059,Y,9,7,0,5,1,0,0,22,1509,Y
Birmingham 008D,E01009233,24,1,25,848,Y,9,9,1,11,0,0,0,30,1319,Y
Birmingham 009A,E01009449,127,12,139,18,N,21,27,25,39,53,160,21,346,25,N
Birmingham 009B,E01009451,22,2,24,885,Y,13,7,0,6,5,1,2,34,1219,Y
Birmingham 009C,E01009453,5,0,5,1592,Y,12,3,0,4,0,0,0,19,1563,Y
Birmingham 009D,E01009466,8,2,10,1405,Y,7,6,0,7,0,0,0,20,1545,Y
Birmingham 009E,E01009471,11,2,13,1288,Y,12,6,1,12,4,0,1,36,1162,Y
Birmingham 010A,E01009135,16,0,16,1171,Y,11,7,0,2,4,0,0,24,1462,Y
Birmingham 010B,E01009469,22,1,23,927,Y,16,8,0,6,0,0,0,30,1319,Y
Birmingham 010C,E01009470,8,1,9,1445,Y,9,9,0,1,1,0,0,20,1545,Y
Birmingham 010D,E01009472,1,0,1,1685,Y,5,9,0,1,2,0,0,17,1593,Y
Birmingham 010E,E01009473,23,5,28,751,Y,23,11,3,14,43,116,3,213,57,Y
Birmingham 010F,E01009474,18,0,18,1103,Y,14,12,0,9,4,23,0,62,554,Y
Birmingham 011A,E01009127,39,1,40,425,Y,9,9,0,11,7,0,0,36,1162,Y
Birmingham 011B,E01009128,12,1,13,1288,Y,6,4,0,16,6,0,0,32,1265,Y
Birmingham 011C,E01009130,41,1,42,391,Y,17,9,1,18,4,0,0,49,830,Y
Birmingham 011D,E01009131,37,3,40,425,Y,7,5,1,25,5,9,1,53,731,Y
Birmingham 011E,E01009133,30,0,30,686,Y,15,5,0,17,2,2,0,41,1044,Y
Birmingham 011F,E01009134,39,5,44,343,Y,14,9,2,22,10,2,1,60,594,Y
Birmingham 011G,E01009137,42,9,51,248,Y,24,14,1,26,9,26,0,100,211,Y
Birmingham 012A,E01009434,9,0,9,1445,Y,8,6,0,1,1,11,0,27,1397,Y
Birmingham 012B,E01009436,6,1,7,1518,Y,7,7,0,2,5,1,0,22,1509,Y
Birmingham 012C,E01009438,11,0,11,1355,Y,4,7,0,3,1,0,0,15,1627,Y
Birmingham 012D,E01009440,9,1,10,1405,Y,5,7,0,5,0,0,0,17,1593,Y
Birmingham 012E,E01009450,7,2,9,1445,Y,12,8,0,6,22,15,0,63,538,Y
Birmingham 013A,E01009223,33,2,35,554,Y,23,27,1,13,98,43,1,206,62,Y
Birmingham 013B,E01009225,26,1,27,781,Y,22,9,0,17,3,0,0,51,782,Y
Birmingham 013C,E01009227,17,2,19,1059,Y,13,10,2,7,1,0,0,33,1242,Y
Birmingham 013D,E01009228,15,2,17,1137,Y,10,7,0,8,0,11,0,36,1162,Y
Birmingham 014A,E01009121,43,5,48,276,Y,35,15,0,20,13,7,0,90,269,Y
Birmingham 014B,E01009122,30,2,32,621,Y,9,9,1,19,1,0,0,39,1104,Y
Birmingham 014C,E01009129,37,1,38,475,Y,7,7,0,25,4,0,0,43,992,Y
Birmingham 014D,E01009132,46,2,48,276,Y,12,5,3,22,7,4,0,53,731,Y
Birmingham 014E,E01009136,34,4,38,475,Y,5,11,1,10,13,1,1,42,1014,Y
Birmingham 015A,E01009457,3,1,4,1626,Y,8,5,0,4,1,0,0,18,1572,Y
Birmingham 015B,E01009459,4,0,4,1626,Y,10,4,0,8,4,0,0,26,1420,Y
Birmingham 015C,E01009461,4,1,5,1592,Y,3,8,2,2,1,0,0,16,1608,Y
Birmingham 015D,E01009463,14,0,14,1251,Y,11,8,0,11,19,16,0,65,504,Y
Birmingham 016A,E01009235,7,0,7,1518,Y,8,9,0,6,3,0,0,26,1420,Y
Birmingham 016B,E01009243,12,1,13,1288,Y,17,11,2,8,3,0,0,41,1044,Y
Birmingham 016C,E01009245,12,0,12,1319,Y,19,10,0,8,5,14,0,56,668,Y
Birmingham 016D,E01009246,15,2,17,1137,Y,11,4,0,1,0,0,0,16,1608,Y
Birmingham 016E,E01009247,17,0,17,1137,Y,17,12,0,4,0,0,0,33,1242,Y
Birmingham 017A,E01009226,15,3,18,1103,Y,17,14,1,8,9,5,1,55,681,Y
Birmingham 017B,E01009229,9,0,9,1445,Y,9,6,0,2,2,0,0,19,1563,Y
Birmingham 017C,E01009230,32,3,35,554,Y,22,5,1,13,9,10,0,60,594,Y
Birmingham 017D,E01009231,12,2,14,1251,Y,18,11,0,6,5,2,0,42,1014,Y
Birmingham 018A,E01009001,18,1,19,1059,Y,10,19,0,10,5,0,0,44,958,Y
Birmingham 018B,E01009003,24,2,26,817,Y,14,13,1,15,8,1,0,52,757,Y
Birmingham 018C,E01009456,19,2,21,989,Y,16,4,0,8,5,0,0,33,1242,Y
Birmingham 018D,E01009458,11,2,13,1288,Y,9,12,0,3,6,1,2,33,1242,Y
Birmingham 018E,E01009460,24,1,25,848,Y,14,7,0,18,6,0,0,45,929,Y
Birmingham 018F,E01009462,25,3,28,751,Y,18,10,2,24,6,52,2,114,177,Y
Birmingham 019A,E01009234,17,1,18,1103,Y,12,3,1,7,3,2,0,28,1373,Y
Birmingham 019B,E01009236,26,7,33,596,Y,17,7,4,5,5,0,0,38,1115,Y
Birmingham 019C,E01009244,17,1,18,1103,Y,24,7,1,6,4,4,1,47,883,Y
Birmingham 019D,E01009248,15,0,15,1217,Y,21,18,1,11,4,0,0,55,681,Y
Birmingham 020A,E01009403,12,2,14,1251,Y,8,3,0,9,0,0,0,20,1545,Y
Birmingham 020B,E01009404,17,0,17,1137,Y,11,5,1,7,5,0,0,29,1346,Y
Birmingham 020C,E01009405,38,2,40,425,Y,18,10,3,19,3,0,1,54,704,Y
Birmingham 020D,E01009406,27,1,28,751,Y,21,12,2,20,6,4,2,67,476,Y
Birmingham 020E,E01009407,28,2,30,686,Y,11,9,1,11,7,0,0,39,1104,Y
Birmingham 021A,E01009439,10,1,11,1355,Y,17,7,0,6,4,0,0,34,1219,Y
Birmingham 021B,E01009441,19,1,20,1025,Y,13,17,1,7,6,0,0,44,958,Y
Birmingham 021C,E01009442,9,0,9,1445,Y,8,6,0,6,3,1,0,24,1462,Y
Birmingham 021D,E01009443,21,4,25,848,Y,9,17,1,7,17,142,2,195,67,N
Birmingham 022A,E01009123,25,4,29,716,Y,16,5,1,10,5,0,0,37,1139,Y
Birmingham 022B,E01009124,48,2,50,257,Y,11,7,3,21,6,0,1,49,830,Y
Birmingham 022C,E01009125,34,2,36,529,Y,15,9,3,16,6,0,0,49,830,Y
Birmingham 022D,E01009232,27,6,33,596,Y,34,17,2,15,22,1,1,92,257,Y
Birmingham 023A,E01009002,48,3,51,248,Y,8,8,1,26,7,0,1,51,782,Y
Birmingham 023C,E01009006,39,0,39,449,Y,20,9,1,10,5,2,0,47,883,Y
Birmingham 023D,E01009007,148,20,168,14,N,39,13,15,39,57,211,22,396,15,Y
Birmingham 023F,E01033632,75,4,79,70,Y,27,23,1,37,16,1,1,106,192,Y
Birmingham 024A,E01009237,30,10,40,425,Y,12,4,0,6,5,20,0,47,883,Y
Birmingham 024B,E01009238,9,0,9,1445,Y,6,3,0,6,1,0,0,16,1608,Y
Birmingham 024C,E01009240,13,2,15,1217,Y,10,5,0,7,1,0,0,23,1483,Y
Birmingham 024D,E01009241,25,1,26,817,Y,22,21,0,9,9,0,0,61,573,Y
Birmingham 024E,E01009242,37,4,41,405,Y,33,8,2,10,50,173,9,285,33,N
Birmingham 025A,E01009005,18,3,21,989,Y,9,6,0,9,7,0,0,31,1290,Y
Birmingham 025B,E01009009,14,0,14,1251,Y,15,4,0,5,3,0,0,27,1397,Y
Birmingham 025C,E01009098,55,6,61,159,Y,7,15,0,23,18,13,2,78,356,Y
Birmingham 025D,E01009100,28,1,29,716,Y,16,11,2,10,3,0,0,42,1014,Y
Birmingham 025E,E01009105,18,3,21,989,Y,19,7,0,8,2,0,0,36,1162,Y
Birmingham 026A,E01009126,11,2,13,1288,Y,11,5,0,6,3,0,0,25,1442,Y
Birmingham 026B,E01009408,17,2,19,1059,Y,8,8,0,11,3,14,0,44,958,Y
Birmingham 026C,E01009409,49,6,55,202,Y,22,10,1,19,12,0,0,64,521,Y
Birmingham 026D,E01009410,51,2,53,217,Y,29,24,4,22,12,9,2,102,202,Y
Birmingham 028A,E01009008,4,0,4,1626,Y,4,1,1,2,1,0,0,9,1671,Y
Birmingham 028B,E01009011,18,1,19,1059,Y,22,8,0,15,7,8,1,61,573,Y
Birmingham 028C,E01009012,6,5,11,1355,Y,19,12,1,8,2,1,1,44,958,Y
Birmingham 028D,E01009102,48,3,51,248,Y,42,19,3,32,53,140,3,292,30,N
Birmingham 028E,E01009104,66,2,68,110,Y,12,6,1,23,6,0,0,48,858,Y
Birmingham 029A,E01009096,36,4,40,425,Y,13,7,3,16,3,0,0,42,1014,Y
Birmingham 029B,E01009097,34,1,35,554,Y,17,7,2,25,6,0,0,57,656,Y
Birmingham 029C,E01009099,56,9,65,135,Y,6,4,1,32,5,0,1,49,830,Y
Birmingham 029D,E01009101,45,2,47,291,Y,5,20,8,30,87,122,2,274,36,N
Birmingham 029E,E01009103,39,3,42,391,Y,5,6,0,42,4,1,0,58,635,Y
Birmingham 029F,E01009106,9,2,11,1355,Y,4,3,0,11,2,0,0,20,1545,Y
Birmingham 030A,E01008915,17,0,17,1137,Y,25,10,1,15,13,1,0,65,504,Y
Birmingham 030B,E01009411,25,4,29,716,Y,24,15,2,17,3,1,0,62,554,Y
Birmingham 030C,E01009412,82,11,93,41,Y,32,23,3,24,14,5,5,106,192,Y
Birmingham 030D,E01009413,49,10,59,169,Y,52,14,2,19,12,0,0,99,224,Y
Birmingham 030E,E01009414,51,6,57,184,Y,29,17,0,17,10,1,0,74,414,Y
Birmingham 031A,E01008998,41,1,42,391,Y,16,9,0,10,15,0,0,50,805,Y
Birmingham 031B,E01008999,16,3,19,1059,Y,18,9,2,5,2,0,1,37,1139,Y
Birmingham 031C,E01009000,60,9,69,107,Y,22,14,1,14,9,0,0,60,594,Y
Birmingham 031D,E01009013,48,8,56,191,Y,23,19,3,31,9,43,3,131,139,Y
Birmingham 031E,E01009400,52,8,60,166,Y,23,11,3,38,24,4,3,106,192,Y
Birmingham 031F,E01009401,34,3,37,496,Y,26,10,1,14,7,0,0,58,635,Y
Birmingham 031H,E01033630,40,3,43,361,Y,7,16,1,9,5,1,1,40,1076,Y
Birmingham 031I,E01033646,70,11,81,64,N,30,28,3,27,33,4,1,126,150,Y
Birmingham 032A,E01009049,28,4,32,621,Y,9,19,2,11,3,0,1,45,929,Y
Birmingham 032B,E01009056,59,11,70,104,Y,27,16,1,24,8,0,2,78,356,Y
Birmingham 032C,E01009263,39,4,43,361,Y,24,12,1,15,7,0,2,61,573,Y
Birmingham 032D,E01009264,32,5,37,496,Y,4,8,0,6,12,0,3,33,1242,Y
Birmingham 032E,E01009265,30,2,32,621,Y,7,10,0,6,13,10,4,50,805,Y
Birmingham 033A,E01009051,40,7,47,291,Y,12,13,2,16,10,8,3,64,521,Y
Birmingham 033B,E01009053,32,3,35,554,Y,5,6,4,10,20,72,4,121,159,Y
Birmingham 033C,E01009054,34,5,39,449,Y,12,8,0,12,2,0,3,37,1139,Y
Birmingham 033D,E01009058,28,2,30,686,Y,1,4,0,13,3,0,0,21,1531,Y
Birmingham 033E,E01009061,17,1,18,1103,Y,2,5,0,7,1,1,0,16,1608,Y
Birmingham 033F,E01009239,83,15,98,32,Y,67,45,8,34,89,3,8,254,39,Y
Birmingham 034A,E01009266,46,9,55,202,Y,16,9,1,18,10,24,5,83,320,Y
Birmingham 034B,E01009269,33,1,34,584,Y,9,14,0,19,2,0,0,44,958,Y
Birmingham 034C,E01009270,30,6,36,529,Y,10,27,1,14,6,0,1,59,618,Y
Birmingham 034D,E01009271,27,0,27,781,Y,9,10,1,8,6,1,1,36,1162,Y
Birmingham 034E,E01009273,28,5,33,596,Y,6,13,3,13,4,13,2,54,704,Y
Birmingham 035A,E01009050,34,2,36,529,Y,12,19,1,11,10,0,1,54,704,Y
Birmingham 035D,E01009057,33,1,34,584,Y,7,8,1,15,8,0,0,39,1104,Y
Birmingham 035E,E01009059,45,2,47,291,Y,12,11,2,10,11,0,1,47,883,Y
Birmingham 035F,E01009060,36,9,45,328,Y,11,12,0,20,12,2,1,58,635,Y
Birmingham 035G,E01033621,57,5,62,156,Y,11,17,4,25,6,0,1,64,521,Y
Birmingham 036A,E01009268,19,1,20,1025,Y,15,11,0,5,3,2,0,36,1162,Y
Birmingham 036B,E01009272,33,2,35,554,Y,15,14,0,19,4,0,0,52,757,Y
Birmingham 036C,E01009274,53,10,63,150,Y,12,18,2,20,10,0,2,64,521,Y
Birmingham 036D,E01009349,49,0,49,269,Y,7,12,1,7,14,11,1,53,731,Y
Birmingham 036E,E01009351,42,11,53,217,Y,8,15,0,14,4,1,2,44,958,Y
Birmingham 036F,E01009354,28,15,43,361,Y,14,14,1,9,12,20,5,75,400,Y
Birmingham 037A,E01008899,40,3,43,361,Y,11,15,2,12,8,1,3,52,757,Y
Birmingham 037C,E01008901,37,6,43,361,Y,8,16,2,18,8,2,0,54,704,Y
Birmingham 037E,E01008916,48,8,56,191,Y,5,11,0,17,10,1,3,47,883,Y
Birmingham 037F,E01033636,52,1,53,217,Y,3,9,0,16,8,0,0,36,1162,Y
Birmingham 038A,E01009079,39,7,46,311,Y,13,11,1,17,5,8,1,56,668,Y
Birmingham 038B,E01009080,20,0,20,1025,Y,4,9,1,33,2,0,0,49,830,Y
Birmingham 038C,E01009081,52,1,53,217,Y,15,16,1,30,5,0,1,68,469,Y
Birmingham 038D,E01009083,44,4,48,276,Y,10,13,1,35,82,7,0,148,110,Y
Birmingham 039A,E01009275,51,13,64,142,Y,12,18,2,18,13,3,17,83,320,Y
Birmingham 039B,E01009350,35,3,38,475,Y,3,13,0,13,5,0,1,35,1190,Y
Birmingham 039C,E01009352,37,4,41,405,Y,14,8,1,17,8,0,3,51,782,Y
Birmingham 039D,E01009353,28,7,35,554,Y,6,13,1,8,5,1,4,38,1115,Y
Birmingham 039E,E01009355,41,5,46,311,Y,10,24,2,25,11,0,3,75,400,Y
Birmingham 039H,E01033635,60,13,73,96,N,24,24,0,42,36,31,15,172,79,Y
Birmingham 040A,E01008905,30,6,36,529,Y,2,13,0,7,3,0,1,26,1420,Y
Birmingham 040B,E01008907,63,9,72,97,Y,9,15,2,17,10,0,3,56,668,Y
Birmingham 040C,E01009047,34,3,37,496,Y,14,11,2,15,14,2,1,59,618,Y
Birmingham 040D,E01009048,66,10,76,80,Y,17,22,2,28,13,3,3,88,277,Y
Birmingham 040E,E01009062,25,1,26,817,Y,4,7,1,9,1,0,1,23,1483,Y
Birmingham 041D,E01008909,31,8,39,449,Y,16,9,1,19,6,0,1,52,757,Y
Birmingham 041F,E01033628,105,5,110,23,Y,14,24,4,26,9,4,1,82,330,Y
Birmingham 041G,E01033637,46,9,55,202,Y,11,14,0,23,6,0,0,54,704,Y
Birmingham 042A,E01009084,20,0,20,1025,Y,12,7,0,7,1,0,0,27,1397,Y
Birmingham 042B,E01009085,10,0,10,1405,Y,7,12,0,7,1,0,0,27,1397,Y
Birmingham 042C,E01009087,27,5,32,621,Y,11,11,3,19,8,10,1,63,538,Y
Birmingham 042D,E01009089,28,1,29,716,Y,9,13,0,9,1,0,0,32,1265,Y
Birmingham 042E,E01009090,41,2,43,361,Y,15,30,2,17,9,24,1,98,232,Y
Birmingham 043A,E01009201,55,4,59,169,Y,10,25,2,26,18,3,2,86,294,Y
Birmingham 043B,E01009202,63,11,74,93,Y,20,24,2,26,46,9,3,130,141,Y
Birmingham 043C,E01009203,54,17,71,99,Y,20,21,2,34,15,3,2,97,238,Y
Birmingham 044A,E01009082,34,2,36,529,Y,14,27,2,11,11,0,0,65,504,Y
Birmingham 044B,E01009086,21,4,25,848,Y,17,14,1,5,3,0,0,40,1076,Y
Birmingham 044C,E01009480,32,1,33,596,Y,10,7,0,8,1,0,0,26,1420,Y
Birmingham 044D,E01009481,54,11,65,135,Y,18,43,5,29,47,44,4,190,69,N
Birmingham 044E,E01009486,44,8,52,232,Y,7,17,1,12,10,0,3,50,805,Y
Birmingham 044F,E01009487,40,3,43,361,Y,8,22,1,9,4,1,3,48,858,Y
Birmingham 045A,E01009088,22,3,25,848,Y,10,17,1,33,4,0,2,67,476,Y
Birmingham 045B,E01009091,19,0,19,1059,Y,9,22,1,18,2,0,0,52,757,Y
Birmingham 045C,E01009305,28,0,28,751,Y,7,10,1,19,5,1,0,43,992,Y
Birmingham 045D,E01009307,40,4,44,343,Y,4,6,2,15,8,0,0,35,1190,Y
Birmingham 045E,E01009309,57,2,59,169,Y,17,17,2,27,15,15,0,93,255,Y
Birmingham 046A,E01009304,36,6,42,391,Y,8,13,2,17,9,16,1,66,490,Y
Birmingham 046B,E01009306,21,7,28,751,Y,6,9,3,23,4,1,0,46,903,Y
Birmingham 046C,E01009308,32,0,32,621,Y,10,16,1,22,8,0,0,57,656,Y
Birmingham 046D,E01009310,34,3,37,496,Y,3,17,2,26,7,0,0,55,681,Y
Birmingham 047A,E01009348,53,9,62,156,Y,17,22,3,20,16,0,2,80,344,Y
Birmingham 047B,E01009358,75,10,85,56,Y,23,20,2,28,20,2,7,102,202,Y
Birmingham 047C,E01009359,53,8,61,159,Y,14,19,1,14,15,3,10,76,387,Y
Birmingham 047D,E01009360,89,7,96,37,N,18,24,3,18,13,0,3,79,349,Y
Birmingham 047E,E01009361,78,5,83,61,N,15,23,1,25,12,3,1,80,344,Y
Birmingham 048A,E01009478,61,5,66,123,Y,21,21,0,28,12,1,1,84,314,Y
Birmingham 048B,E01009479,43,5,48,276,Y,13,24,0,22,2,0,0,61,573,Y
Birmingham 048C,E01009482,23,1,24,885,Y,2,8,0,13,5,0,0,28,1373,Y
Birmingham 048D,E01009484,61,7,68,110,Y,10,20,1,16,36,5,1,89,275,Y
Birmingham 048E,E01009485,16,1,17,1137,Y,3,6,0,7,1,0,0,17,1593,Y
Birmingham 049A,E01008906,31,2,33,596,Y,10,16,1,11,2,1,0,41,1044,Y
Birmingham 049B,E01008911,22,5,27,781,Y,10,10,0,13,7,0,0,40,1076,Y
Birmingham 049D,E01009347,43,17,60,166,Y,14,18,3,23,8,0,1,67,476,Y
Birmingham 049E,E01033559,41,7,48,276,Y,20,45,2,15,21,7,4,114,177,Y
Birmingham 049F,E01033638,68,9,77,75,Y,14,25,1,16,17,0,4,77,371,Y
Birmingham 050A,E01008910,50,8,58,179,Y,17,12,1,24,14,2,2,72,427,Y
Birmingham 050B,E01008913,55,4,59,169,Y,16,12,0,15,9,13,4,69,456,Y
Birmingham 050C,E01008914,65,17,82,62,Y,14,51,3,25,35,6,7,141,119,N
Birmingham 050E,E01033561,174,67,241,8,N,46,133,35,72,153,320,95,854,6,N
Birmingham 050F,E01033617,220,27,247,7,N,32,41,17,52,96,96,26,360,22,N
Birmingham 051A,E01009194,56,5,61,159,Y,3,32,2,19,6,1,3,66,490,Y
Birmingham 051B,E01009483,72,8,80,65,Y,8,28,1,22,17,6,4,86,294,Y
Birmingham 051C,E01009488,35,5,40,425,Y,9,18,0,20,6,0,1,54,704,Y
Birmingham 051D,E01009489,29,3,32,621,Y,7,17,0,12,11,0,0,47,883,Y
Birmingham 051E,E01009491,44,3,47,291,Y,17,15,1,22,7,1,0,63,538,Y
Birmingham 052B,E01009192,39,1,40,425,Y,7,8,0,7,6,1,2,31,1290,Y
Birmingham 052D,E01009199,24,7,31,655,Y,14,24,2,13,4,4,2,63,538,Y
Birmingham 052E,E01009204,35,7,42,391,Y,14,34,3,32,10,1,2,96,243,Y
Birmingham 052F,E01033644,69,11,80,65,Y,7,48,0,33,11,5,0,104,200,N
Birmingham 053A,E01009151,25,3,28,751,Y,10,14,0,7,9,0,2,42,1014,Y
Birmingham 053B,E01009152,30,1,31,655,Y,4,8,2,11,4,0,0,29,1346,Y
Birmingham 053C,E01009153,61,19,80,65,Y,16,44,2,34,28,0,5,129,143,Y
Birmingham 053D,E01009345,188,13,201,9,N,11,53,3,39,38,27,6,177,77,Y
Birmingham 053E,E01009346,75,19,94,38,Y,15,26,0,20,12,2,5,80,344,Y
Birmingham 054A,E01009092,45,4,49,269,Y,7,15,1,13,6,0,0,42,1014,Y
Birmingham 054B,E01009093,43,5,48,276,Y,10,15,2,26,5,1,1,60,594,Y
Birmingham 054C,E01009094,16,0,16,1171,Y,4,6,1,8,2,0,0,21,1531,Y
Birmingham 054D,E01009298,43,1,44,343,Y,9,14,3,10,7,0,0,43,992,Y
Birmingham 054E,E01009311,41,5,46,311,Y,13,14,8,29,12,16,0,92,257,Y
Birmingham 054F,E01009511,28,2,30,686,Y,11,14,6,36,20,18,0,105,197,Y
Birmingham 055A,E01009475,33,4,37,496,Y,4,14,0,16,3,0,0,37,1139,Y
Birmingham 055B,E01009476,82,12,94,38,Y,13,18,2,26,11,1,4,75,400,Y
Birmingham 055C,E01009477,23,2,25,848,Y,10,8,3,17,2,0,0,40,1076,Y
Birmingham 055D,E01009490,53,3,56,191,Y,12,13,0,15,4,0,2,46,903,Y
Birmingham 055E,E01009492,30,2,32,621,Y,9,10,0,14,3,1,2,39,1104,Y
Birmingham 056A,E01009095,37,2,39,449,Y,16,22,2,21,71,84,1,217,55,Y
Birmingham 056B,E01009507,32,5,37,496,Y,6,16,0,16,10,4,0,52,757,Y
Birmingham 056C,E01009508,7,1,8,1484,Y,7,9,0,5,3,0,0,24,1462,Y
Birmingham 056D,E01009509,63,3,66,123,Y,19,26,4,23,17,0,1,90,269,Y
Birmingham 056E,E01009510,34,3,37,496,Y,15,21,0,18,3,0,1,58,635,Y
Birmingham 057A,E01009297,28,0,28,751,Y,8,21,0,21,27,0,0,77,371,Y
Birmingham 057B,E01009299,43,2,45,328,Y,15,18,1,18,16,17,2,87,286,Y
Birmingham 057C,E01009300,48,6,54,212,Y,23,12,3,29,4,2,1,74,414,Y
Birmingham 057D,E01009301,53,6,59,169,Y,18,11,2,23,10,0,0,64,521,Y
Birmingham 057E,E01009303,32,2,34,584,Y,17,15,1,16,8,2,1,60,594,Y
Birmingham 058A,E01009195,27,1,28,751,Y,10,13,2,9,1,1,0,36,1162,Y
Birmingham 058C,E01009197,43,9,52,232,Y,6,10,1,10,16,4,1,48,858,Y
Birmingham 058D,E01009198,66,3,69,107,Y,17,31,0,19,8,0,2,77,371,Y
Birmingham 058E,E01033647,23,4,27,781,Y,4,4,1,7,3,14,2,35,1190,Y
Birmingham 058F,E01033649,12,2,14,1251,Y,6,9,0,3,1,0,1,20,1545,Y
Birmingham 060A,E01009138,37,6,43,361,Y,13,12,1,8,6,0,2,42,1014,Y
Birmingham 060B,E01009139,8,2,10,1405,Y,4,12,0,5,2,0,0,23,1483,Y
Birmingham 060C,E01009140,50,14,64,142,Y,20,36,2,16,8,0,0,82,330,Y
Birmingham 060D,E01009145,30,7,37,496,Y,15,34,1,16,7,2,1,76,387,Y
Birmingham 060E,E01009147,33,4,37,496,Y,15,15,0,10,2,1,1,44,958,Y
Birmingham 062A,E01009512,45,1,46,311,Y,10,11,5,17,13,0,0,56,668,Y
Birmingham 062B,E01009514,30,6,36,529,Y,7,14,0,27,6,11,1,66,490,Y
Birmingham 062C,E01009516,20,3,23,927,Y,7,9,0,15,3,0,1,35,1190,Y
Birmingham 062D,E01009517,31,1,32,621,Y,8,9,1,22,3,8,0,51,782,Y
Birmingham 063A,E01009325,20,1,21,989,Y,7,5,0,10,4,0,0,26,1420,Y
Birmingham 063D,E01009342,20,4,24,885,Y,8,4,2,8,2,1,0,25,1442,Y
Birmingham 063E,E01009343,103,1,104,28,N,13,21,1,14,8,10,0,67,476,Y
Birmingham 063F,E01033642,21,5,26,817,Y,8,6,0,11,3,0,0,28,1373,Y
Birmingham 064A,E01008986,37,6,43,361,Y,18,53,3,25,12,2,3,116,175,N
Birmingham 064B,E01008987,40,7,47,291,Y,20,32,0,26,14,1,1,94,252,Y
Birmingham 064C,E01008988,40,12,52,232,Y,15,47,3,25,21,0,4,115,176,N
Birmingham 064D,E01008989,21,2,23,927,Y,23,44,0,20,17,0,2,106,192,Y
Birmingham 064E,E01008990,16,2,18,1103,Y,30,22,5,8,23,0,0,88,277,Y
Birmingham 064F,E01008991,6,3,9,1445,Y,17,57,0,7,17,0,0,98,232,Y
Birmingham 066A,E01008882,38,4,42,391,Y,7,16,0,18,5,0,0,46,903,Y
Birmingham 066B,E01008896,25,3,28,751,Y,10,11,2,12,1,1,0,37,1139,Y
Birmingham 066C,E01008898,39,5,44,343,Y,14,13,1,14,2,0,1,45,929,Y
Birmingham 066D,E01009326,28,3,31,655,Y,10,9,0,13,2,3,1,38,1115,Y
Birmingham 066E,E01009341,84,7,91,44,Y,8,25,1,24,36,28,6,128,147,Y
Birmingham 066F,E01009513,48,5,53,217,Y,15,26,1,19,5,4,1,71,436,Y
Birmingham 067A,E01008881,52,12,64,142,Y,16,14,1,20,13,33,0,97,238,Y
Birmingham 067B,E01008897,17,1,18,1103,Y,7,20,0,12,3,0,2,44,958,Y
Birmingham 067C,E01009515,25,1,26,817,Y,10,12,1,12,3,0,2,40,1076,Y
Birmingham 067D,E01009518,20,7,27,781,Y,7,20,0,6,5,1,1,40,1076,Y
Birmingham 067E,E01009521,10,1,11,1355,Y,11,11,3,6,11,24,1,67,476,Y
Birmingham 069A,E01009302,22,3,25,848,Y,20,15,0,12,3,4,1,55,681,Y
Birmingham 069B,E01009314,55,6,61,159,Y,17,18,6,38,7,18,4,108,187,Y
Birmingham 069C,E01009321,44,7,51,248,Y,19,20,1,40,6,0,0,86,294,Y
Birmingham 069D,E01009322,73,6,79,70,Y,25,20,3,73,14,1,0,136,124,Y
Birmingham 069E,E01009323,24,0,24,885,Y,19,11,4,28,7,0,0,69,456,Y
Birmingham 070A,E01009329,37,5,42,391,Y,10,20,1,13,6,3,0,53,731,Y
Birmingham 070B,E01009334,4,1,5,1592,Y,1,10,1,6,1,0,0,19,1563,Y
Birmingham 070C,E01009337,16,0,16,1171,Y,5,10,0,8,1,0,0,24,1462,Y
Birmingham 070D,E01009338,29,9,38,475,Y,4,21,0,15,7,0,2,49,830,Y
Birmingham 070E,E01009380,28,7,35,554,Y,4,14,0,20,7,2,1,48,858,Y
Birmingham 071A,E01009362,36,9,45,328,Y,7,21,2,17,12,0,3,62,554,Y
Birmingham 071B,E01009363,54,5,59,169,Y,14,64,3,10,31,0,0,122,156,Y
Birmingham 071C,E01009364,52,9,61,159,Y,12,61,1,33,14,0,1,122,156,Y
Birmingham 071D,E01009365,82,11,93,41,Y,20,45,1,32,19,4,8,129,143,Y
Birmingham 071E,E01009379,70,12,82,62,Y,22,87,2,26,24,29,2,192,68,N
Birmingham 072A,E01009312,12,4,16,1171,Y,9,7,0,5,0,0,0,21,1531,Y
Birmingham 072B,E01009324,29,2,31,655,Y,13,14,0,11,3,0,1,42,1014,Y
Birmingham 072C,E01009519,6,1,7,1518,Y,13,4,0,11,1,0,0,29,1346,Y
Birmingham 072D,E01009520,11,5,16,1171,Y,11,5,0,3,1,0,0,20,1545,Y
Birmingham 073A,E01009066,34,3,37,496,Y,14,15,0,16,10,3,3,61,573,Y
Birmingham 073B,E01009070,19,8,27,781,Y,11,23,0,8,3,0,1,46,903,Y
Birmingham 073C,E01009252,5,0,5,1592,Y,14,18,2,10,8,0,0,52,757,Y
Birmingham 073D,E01009260,14,3,17,1137,Y,21,24,0,5,10,0,2,62,554,Y
Birmingham 073E,E01009261,5,1,6,1556,Y,17,21,0,22,2,20,0,82,330,Y
Birmingham 074A,E01008984,23,9,32,621,Y,15,8,0,7,6,10,0,46,903,Y
Birmingham 074B,E01008994,28,12,40,425,Y,17,29,6,20,19,101,7,199,64,N
Birmingham 074C,E01008996,19,4,23,927,Y,15,4,1,13,3,0,2,38,1115,Y
Birmingham 074D,E01008997,18,7,25,848,Y,10,9,2,9,5,16,0,51,782,Y
Birmingham 075A,E01009065,18,7,25,848,Y,10,11,0,8,4,7,1,41,1044,Y
Birmingham 075B,E01009067,7,1,8,1484,Y,14,10,2,3,2,0,0,31,1290,Y
Birmingham 075C,E01009068,30,2,32,621,Y,14,29,6,10,48,57,3,167,86,N
Birmingham 075D,E01009069,19,1,20,1025,Y,30,14,1,9,15,88,1,158,97,N
Birmingham 075E,E01009072,5,0,5,1592,Y,15,9,1,10,10,0,0,45,929,Y
Birmingham 076A,E01008885,8,0,8,1484,Y,9,10,0,8,2,0,0,29,1346,Y
Birmingham 076B,E01008886,40,3,43,361,Y,6,25,4,15,158,186,2,396,15,Y
Birmingham 076C,E01008888,12,4,16,1171,Y,13,37,0,10,8,11,2,81,340,Y
Birmingham 076D,E01009313,3,0,3,1651,Y,7,13,1,7,2,0,0,30,1319,Y
Birmingham 077A,E01009368,18,3,21,989,Y,2,4,2,10,4,0,2,24,1462,Y
Birmingham 077D,E01009371,62,14,76,80,Y,24,39,2,25,24,23,2,139,120,Y
Birmingham 077E,E01009397,32,6,38,475,Y,16,21,1,22,10,2,2,74,414,Y
Birmingham 077F,E01033650,50,3,53,217,Y,9,21,0,18,4,0,1,53,731,Y
Birmingham 078A,E01008883,30,2,32,621,Y,12,18,0,12,4,2,0,48,858,Y
Birmingham 078B,E01008884,43,9,52,232,Y,25,27,0,13,5,28,0,98,232,Y
Birmingham 078C,E01008887,31,2,33,596,Y,7,28,2,10,8,1,0,56,668,Y
Birmingham 078D,E01008889,26,5,31,655,Y,19,46,0,16,51,0,2,134,129,Y
Birmingham 079A,E01008982,39,2,41,405,Y,14,15,5,15,10,5,0,64,521,Y
Birmingham 079C,E01008992,9,1,10,1405,Y,12,22,2,3,9,0,0,48,858,Y
Birmingham 079E,E01009283,16,3,19,1059,Y,28,25,3,12,27,2,2,99,224,Y
Birmingham 079F,E01033631,35,6,41,405,Y,71,65,175,22,135,3,5,476,11,N
Birmingham 080A,E01009249,18,7,25,848,Y,8,11,0,5,6,5,0,35,1190,Y
Birmingham 080B,E01009250,19,5,24,885,Y,10,15,0,15,10,4,1,55,681,Y
Birmingham 080C,E01009251,6,1,7,1518,Y,17,12,0,26,98,2,0,155,102,Y
Birmingham 080D,E01009253,15,4,19,1059,Y,9,13,1,9,4,6,3,45,929,Y
Birmingham 080E,E01009255,36,4,40,425,Y,4,14,1,14,6,1,1,41,1044,Y
Birmingham 080F,E01009257,28,8,36,529,Y,6,9,0,14,4,0,0,33,1242,Y
Birmingham 081A,E01009315,31,2,33,596,Y,12,27,2,19,12,89,2,163,91,Y
Birmingham 081B,E01009316,15,1,16,1171,Y,15,17,1,14,17,4,2,70,445,Y
Birmingham 081C,E01009317,47,0,47,291,Y,22,14,0,23,9,0,1,69,456,Y
Birmingham 081D,E01009318,10,1,11,1355,Y,15,5,1,8,1,0,0,30,1319,Y
Birmingham 081E,E01009319,4,0,4,1626,Y,11,7,0,4,1,0,0,23,1483,Y
Birmingham 081F,E01009320,25,8,33,596,Y,24,20,6,15,11,40,1,117,172,Y
Birmingham 082A,E01009372,15,5,20,1025,Y,1,9,0,2,1,0,0,13,1649,Y
Birmingham 082B,E01009373,14,5,19,1059,Y,0,6,0,5,2,0,0,13,1649,Y
Birmingham 082D,E01009396,35,9,44,343,Y,14,19,2,10,6,5,0,56,668,Y
Birmingham 082F,E01033643,32,5,37,496,Y,4,17,1,11,1,1,1,36,1162,Y
Birmingham 083A,E01009367,76,10,86,52,Y,16,28,5,24,22,5,0,100,211,Y
Birmingham 083B,E01009375,43,9,52,232,Y,13,23,1,13,5,1,1,57,656,Y
Birmingham 083C,E01009377,14,4,18,1103,Y,7,6,0,5,6,0,0,24,1462,Y
Birmingham 083D,E01009383,15,1,16,1171,Y,4,9,1,7,1,0,0,22,1509,Y
Birmingham 083E,E01009399,47,7,54,212,Y,8,10,3,14,6,5,0,46,903,Y
Birmingham 084A,E01009366,29,8,37,496,Y,14,10,2,16,3,0,0,45,929,Y
Birmingham 084B,E01009374,23,1,24,885,Y,11,8,3,8,5,0,0,35,1190,Y
Birmingham 084C,E01009376,50,6,56,191,Y,15,16,8,19,19,6,1,84,314,Y
Birmingham 084F,E01033648,54,5,59,169,Y,19,12,0,13,4,4,1,53,731,Y
Birmingham 085A,E01009073,39,0,39,449,Y,5,7,0,9,2,0,0,23,1483,Y
Birmingham 085B,E01009074,33,5,38,475,Y,7,5,0,16,7,3,0,38,1115,Y
Birmingham 085C,E01009254,29,8,37,496,Y,19,15,0,22,6,28,0,90,269,Y
Birmingham 085D,E01009256,19,3,22,965,Y,4,10,0,6,3,0,0,23,1483,Y
Birmingham 085E,E01009258,19,3,22,965,Y,7,10,1,5,2,0,1,26,1420,Y
Birmingham 087B,E01009071,10,5,15,1217,Y,26,15,5,6,11,1,1,65,504,Y
Birmingham 087C,E01009075,19,1,20,1025,Y,8,22,2,11,1,0,0,44,958,Y
Birmingham 087E,E01009078,17,2,19,1059,Y,27,13,0,6,29,2,0,77,371,Y
Birmingham 087F,E01033562,132,3,135,19,N,28,37,51,32,79,6,4,237,47,N
Birmingham 088C,E01009183,17,2,19,1059,Y,14,28,5,6,16,0,2,71,436,Y
Birmingham 088D,E01009186,19,10,29,716,Y,35,13,2,13,6,0,0,69,456,Y
Birmingham 088E,E01033645,35,7,42,391,Y,18,16,1,19,11,0,5,70,445,Y
Birmingham 089A,E01008890,33,3,36,529,Y,14,21,0,13,2,0,1,51,782,Y
Birmingham 089B,E01008891,11,1,12,1319,Y,11,21,0,12,6,0,0,50,805,Y
Birmingham 089C,E01008892,26,3,29,716,Y,5,11,0,12,2,0,0,30,1319,Y
Birmingham 089D,E01008893,18,5,23,927,Y,3,13,1,4,1,0,0,22,1509,Y
Birmingham 089E,E01008894,35,7,42,391,Y,14,27,5,21,14,42,2,125,153,Y
Birmingham 089F,E01008895,21,1,22,965,Y,6,28,3,7,4,2,0,50,805,Y
Birmingham 089G,E01009015,55,9,64,142,Y,17,14,8,12,15,59,8,133,133,N
Birmingham 090A,E01009014,25,4,29,716,Y,14,12,2,9,1,0,2,40,1076,Y
Birmingham 090B,E01009018,39,3,42,391,Y,8,25,4,14,52,6,1,110,183,Y
Birmingham 090C,E01009026,29,2,31,655,Y,8,9,0,18,6,1,0,42,1014,Y
Birmingham 090D,E01009028,29,4,33,596,Y,4,12,1,20,4,0,0,41,1044,Y
Birmingham 090E,E01009029,23,1,24,885,Y,11,13,2,12,6,0,0,44,958,Y
Birmingham 092A,E01009182,41,2,43,361,Y,16,36,2,20,6,2,0,82,330,Y
Birmingham 092B,E01009184,54,6,60,166,Y,17,18,7,18,79,14,4,157,98,Y
Birmingham 092C,E01009187,17,1,18,1103,Y,31,26,2,7,6,0,0,72,427,Y
Birmingham 092D,E01009188,20,5,25,848,Y,9,14,6,11,14,6,4,64,521,Y
Birmingham 092E,E01009384,33,2,35,554,Y,11,15,0,18,8,0,2,54,704,Y
Birmingham 092F,E01009385,36,7,43,361,Y,17,22,8,24,19,38,4,132,134,Y
Birmingham 093A,E01009185,14,5,19,1059,Y,23,25,1,10,3,0,0,62,554,Y
Birmingham 093B,E01009389,25,1,26,817,Y,5,5,0,6,2,0,0,18,1572,Y
Birmingham 093C,E01009390,18,2,20,1025,Y,10,8,1,14,8,0,0,41,1044,Y
Birmingham 093D,E01009394,16,3,19,1059,Y,11,9,1,10,2,0,0,33,1242,Y
Birmingham 094A,E01008918,46,4,50,257,Y,18,8,0,16,8,2,1,53,731,Y
Birmingham 094B,E01008920,6,2,8,1484,Y,3,13,1,9,5,0,0,31,1290,Y
Birmingham 094C,E01008921,27,2,29,716,Y,10,19,0,10,17,1,1,58,635,Y
Birmingham 094D,E01008931,46,2,48,276,Y,11,5,0,20,6,0,0,42,1014,Y
Birmingham 094E,E01009259,36,3,39,449,Y,6,11,2,18,4,0,0,41,1044,Y
Birmingham 095A,E01008919,23,2,25,848,Y,14,11,3,19,6,0,0,53,731,Y
Birmingham 095B,E01009064,21,1,22,965,Y,7,9,1,15,2,0,0,34,1219,Y
Birmingham 095C,E01009077,37,1,38,475,Y,11,20,1,13,5,0,1,51,782,Y
Birmingham 095D,E01009291,24,0,24,885,Y,7,7,3,5,1,0,1,24,1462,Y
Birmingham 095E,E01009500,33,6,39,449,Y,14,23,4,20,14,95,2,172,79,Y
Birmingham 096A,E01009284,57,4,61,159,Y,56,40,11,25,37,87,1,257,38,N
Birmingham 096C,E01009286,13,1,14,1251,Y,21,10,6,8,6,0,0,51,782,Y
Birmingham 096E,E01009289,8,2,10,1405,Y,13,7,2,5,9,16,0,52,757,Y
Birmingham 096F,E01009290,11,1,12,1319,Y,6,13,3,2,7,2,0,33,1242,Y
Birmingham 096G,E01033634,56,7,63,150,Y,34,18,6,16,35,56,3,168,84,Y
Birmingham 097A,E01009017,22,9,31,655,Y,19,16,2,7,6,0,0,50,805,Y
Birmingham 097B,E01009043,26,2,28,751,Y,21,18,0,12,5,2,0,58,635,Y
Birmingham 097C,E01009044,33,8,41,405,Y,8,11,4,11,4,1,2,41,1044,Y
Birmingham 097D,E01009045,43,9,52,232,Y,15,24,1,10,13,8,1,72,427,Y
Birmingham 097E,E01009046,16,3,19,1059,Y,13,17,0,9,2,0,1,42,1014,Y
Birmingham 097F,E01009395,18,0,18,1103,Y,9,8,1,4,3,0,0,25,1442,Y
Birmingham 098A,E01009016,23,2,25,848,Y,10,16,1,18,14,2,0,61,573,Y
Birmingham 098B,E01009022,20,6,26,817,Y,14,22,4,11,5,0,2,58,635,Y
Birmingham 098C,E01009023,14,2,16,1171,Y,14,18,1,9,3,0,1,46,903,Y
Birmingham 098D,E01009030,8,0,8,1484,Y,9,14,1,9,0,0,0,33,1242,Y
Birmingham 099A,E01009281,14,1,15,1217,Y,4,10,1,6,9,3,0,33,1242,Y
Birmingham 099B,E01009292,11,3,14,1251,Y,7,13,1,9,3,0,1,34,1219,Y
Birmingham 099C,E01009294,37,1,38,475,Y,12,27,2,16,10,3,1,71,436,Y
Birmingham 099D,E01009295,25,0,25,848,Y,12,8,0,3,3,0,2,28,1373,Y
Birmingham 100A,E01009280,38,1,39,449,Y,16,15,1,7,5,0,1,45,929,Y
Birmingham 100B,E01009282,42,4,46,311,Y,18,15,0,20,12,2,1,68,469,Y
Birmingham 100C,E01009288,4,1,5,1592,Y,13,22,0,6,6,0,0,47,883,Y
Birmingham 100D,E01009293,17,4,21,989,Y,11,16,2,12,8,0,0,49,830,Y
Birmingham 100E,E01009296,40,0,40,425,Y,27,18,4,11,5,0,0,65,504,Y
Birmingham 101A,E01008924,29,3,32,621,Y,12,8,2,26,0,3,1,52,757,Y
Birmingham 101B,E01009501,38,6,44,343,Y,11,15,0,18,5,29,0,78,356,Y
Birmingham 101C,E01009502,52,3,55,202,Y,5,12,2,21,18,1,0,59,618,Y
Birmingham 101D,E01009503,36,4,40,425,Y,10,14,1,24,4,0,2,55,681,Y
Birmingham 101E,E01009505,31,0,31,655,Y,12,13,2,26,5,0,0,58,635,Y
Birmingham 102A,E01008917,6,0,6,1556,Y,5,5,0,5,2,0,0,17,1593,Y
Birmingham 102B,E01008923,39,5,44,343,Y,14,10,0,17,5,0,0,46,903,Y
Birmingham 102C,E01008925,6,2,8,1484,Y,4,6,0,5,1,0,0,16,1608,Y
Birmingham 102D,E01008927,37,0,37,496,Y,7,13,0,25,3,3,1,52,757,Y
Birmingham 102E,E01008928,28,4,32,621,Y,3,6,0,17,4,2,0,32,1265,Y
Birmingham 103A,E01009019,39,7,46,311,Y,19,24,5,29,7,0,2,86,294,Y
Birmingham 103B,E01009020,19,1,20,1025,Y,7,8,1,6,3,0,0,25,1442,Y
Birmingham 103C,E01009021,45,3,48,276,Y,6,14,1,20,4,0,0,45,929,Y
Birmingham 103D,E01009024,21,3,24,885,Y,15,15,5,28,5,8,0,76,387,Y
Birmingham 103E,E01009025,17,2,19,1059,Y,10,16,0,32,9,0,1,68,469,Y
Birmingham 103F,E01009033,34,3,37,496,Y,9,7,2,16,7,0,0,41,1044,Y
Birmingham 104A,E01009175,17,2,19,1059,Y,10,22,3,8,6,0,0,49,830,Y
Birmingham 104B,E01009177,16,2,18,1103,Y,7,19,0,8,2,2,1,39,1104,Y
Birmingham 104C,E01009178,54,9,63,150,Y,26,27,12,31,53,215,20,384,18,N
Birmingham 104D,E01009179,23,3,26,817,Y,13,22,3,21,11,1,0,71,436,Y
Birmingham 104E,E01009189,9,0,9,1445,Y,12,30,2,11,3,17,1,76,387,Y
Birmingham 105A,E01008933,32,7,39,449,Y,14,13,1,17,4,0,1,50,805,Y
Birmingham 105B,E01008934,4,3,7,1518,Y,7,22,0,6,3,0,0,38,1115,Y
Birmingham 105C,E01009031,12,4,16,1171,Y,12,14,2,11,1,0,0,40,1076,Y
Birmingham 105D,E01009037,16,1,17,1137,Y,13,18,1,7,1,0,0,40,1076,Y
Birmingham 105E,E01009176,18,7,25,848,Y,29,22,1,12,2,10,0,76,387,Y
Birmingham 106C,E01008929,42,9,51,248,Y,13,12,0,24,8,0,0,57,656,Y
Birmingham 106D,E01008930,39,1,40,425,Y,7,26,2,31,4,2,0,72,427,Y
Birmingham 106E,E01009495,31,2,33,596,Y,12,10,0,27,1,0,0,50,805,Y
Birmingham 106F,E01033629,32,5,37,496,Y,16,19,2,27,17,13,2,96,243,Y
Birmingham 107A,E01008953,16,0,16,1171,Y,6,10,1,10,4,0,0,31,1290,Y
Birmingham 107B,E01008963,21,2,23,927,Y,8,14,3,13,6,0,1,45,929,Y
Birmingham 107C,E01008964,12,0,12,1319,Y,4,9,3,2,8,6,0,32,1265,Y
Birmingham 107D,E01008965,19,1,20,1025,Y,13,14,0,7,4,0,0,38,1115,Y
Birmingham 107E,E01008966,41,4,45,328,Y,16,13,1,19,8,19,0,76,387,Y
Birmingham 108A,E01009032,28,2,30,686,Y,22,24,0,12,2,0,0,60,594,Y
Birmingham 108B,E01009034,10,0,10,1405,Y,4,7,0,6,2,0,0,19,1563,Y
Birmingham 108C,E01009035,23,1,24,885,Y,5,20,3,6,10,7,4,55,681,Y
Birmingham 108D,E01009036,8,3,11,1355,Y,5,9,2,2,2,5,0,25,1442,Y
Birmingham 109A,E01009494,38,3,41,405,Y,20,16,1,41,7,0,0,85,305,Y
Birmingham 109B,E01009496,8,1,9,1445,Y,19,11,1,9,4,0,0,44,958,Y
Birmingham 109C,E01009497,36,6,42,391,Y,30,32,5,29,20,63,4,183,72,Y
Birmingham 109D,E01009504,45,3,48,276,Y,6,8,0,16,4,1,0,35,1190,Y
Birmingham 109E,E01009506,7,0,7,1518,Y,13,19,0,9,0,0,0,41,1044,Y
Birmingham 110A,E01008967,16,0,16,1171,Y,10,19,3,5,5,15,0,57,656,Y
Birmingham 110B,E01008968,14,3,17,1137,Y,18,16,0,7,3,0,0,44,958,Y
Birmingham 110C,E01008970,18,0,18,1103,Y,2,7,0,14,4,0,0,27,1397,Y
Birmingham 110D,E01008981,16,4,20,1025,Y,8,24,6,10,57,39,7,151,106,Y
Birmingham 111A,E01008932,14,1,15,1217,Y,8,10,3,11,8,0,1,41,1044,Y
Birmingham 111B,E01008935,51,3,54,212,Y,20,24,7,18,7,1,1,78,356,Y
Birmingham 111C,E01008936,37,2,39,449,Y,7,12,1,22,4,0,0,46,903,Y
Birmingham 111D,E01008938,20,0,20,1025,Y,8,7,1,8,0,0,0,24,1462,Y
Birmingham 111E,E01008939,33,4,37,496,Y,11,22,2,19,1,0,0,55,681,Y
Birmingham 112A,E01008951,5,1,6,1556,Y,7,17,0,4,2,0,0,30,1319,Y
Birmingham 112B,E01008952,44,2,46,311,Y,18,20,1,19,11,51,1,121,159,Y
Birmingham 112C,E01008955,22,1,23,927,Y,18,37,2,14,7,6,1,85,305,Y
Birmingham 112D,E01008956,3,0,3,1651,Y,11,7,1,5,3,5,0,32,1265,Y
Birmingham 112E,E01008957,40,5,45,328,Y,25,25,2,15,18,1,1,87,286,Y
Birmingham 113A,E01008950,22,3,25,848,Y,7,16,0,10,2,0,0,35,1190,Y
Birmingham 113B,E01008954,11,1,12,1319,Y,10,8,2,1,6,0,0,27,1397,Y
Birmingham 113C,E01008958,25,4,29,716,Y,8,12,1,23,3,0,0,47,883,Y
Birmingham 113D,E01009493,49,4,53,217,Y,16,18,6,29,5,0,1,75,400,Y
Birmingham 115A,E01008937,22,5,27,781,Y,6,21,2,13,3,0,1,46,903,Y
Birmingham 115B,E01008940,49,3,52,232,Y,8,11,3,27,6,0,0,55,681,Y
Birmingham 115C,E01008941,29,1,30,686,Y,10,12,1,10,4,0,0,37,1139,Y
Birmingham 115D,E01008944,24,3,27,781,Y,9,16,0,5,1,0,0,31,1290,Y
Birmingham 116A,E01008959,17,2,19,1059,Y,8,6,0,5,5,0,0,24,1462,Y
Birmingham 116B,E01008960,19,4,23,927,Y,8,25,2,8,5,7,1,56,668,Y
Birmingham 116C,E01008961,29,3,32,621,Y,12,3,1,16,8,9,2,51,782,Y
Birmingham 116D,E01008962,61,5,66,123,Y,17,14,0,25,4,0,0,60,594,Y
Birmingham 117A,E01008942,25,3,28,751,Y,8,17,1,7,1,0,0,34,1219,Y
Birmingham 117B,E01008943,26,0,26,817,Y,18,14,2,12,18,1,1,66,490,Y
Birmingham 117C,E01008969,17,2,19,1059,Y,11,29,3,13,1,0,0,57,656,Y
Birmingham 117D,E01008971,28,2,30,686,Y,13,18,2,14,11,3,0,61,573,Y
Birmingham 118A,E01008972,42,3,45,328,Y,8,8,2,6,8,0,0,32,1265,Y
Birmingham 118B,E01008973,25,3,28,751,Y,20,26,2,23,6,7,1,85,305,Y
Birmingham 118C,E01008974,28,6,34,584,Y,23,29,0,12,6,0,0,70,445,Y
Birmingham 118D,E01008975,13,0,13,1288,Y,11,9,0,7,5,1,1,34,1219,Y
Birmingham 119A,E01009172,48,2,50,257,Y,8,10,0,15,6,0,0,39,1104,Y
Birmingham 119B,E01009173,38,1,39,449,Y,9,18,3,15,5,1,1,52,757,Y
Birmingham 119C,E01009174,39,4,43,361,Y,16,25,0,20,12,0,3,76,387,Y
Birmingham 119D,E01009498,31,2,33,596,Y,7,13,0,15,5,0,0,40,1076,Y
Birmingham 119E,E01009499,38,3,41,405,Y,16,20,1,11,53,93,4,198,65,Y
Birmingham 120A,E01009205,16,4,20,1025,Y,15,13,3,11,12,0,0,54,704,Y
Birmingham 120B,E01009206,21,2,23,927,Y,23,22,1,16,15,7,0,84,314,Y
Birmingham 120C,E01009211,14,1,15,1217,Y,7,16,1,9,1,0,0,34,1219,Y
Birmingham 120D,E01009218,14,8,22,965,Y,14,13,4,6,5,4,2,48,858,Y
Birmingham 120E,E01009219,26,3,29,716,Y,15,12,1,19,15,94,7,163,91,Y
Birmingham 121A,E01008976,44,6,50,257,Y,14,16,1,31,15,5,0,82,330,Y
Birmingham 121B,E01008978,86,4,90,47,Y,14,19,0,32,13,3,1,82,330,Y
Birmingham 121C,E01008979,50,3,53,217,Y,13,6,0,33,12,1,0,65,504,Y
Birmingham 121D,E01008980,66,1,67,116,Y,18,13,3,47,20,0,0,101,210,N
Birmingham 122A,E01008945,45,5,50,257,Y,8,27,2,20,27,13,2,99,224,Y
Birmingham 122B,E01008946,20,2,22,965,Y,6,22,0,7,3,1,1,40,1076,Y
Birmingham 122C,E01008947,16,2,18,1103,Y,20,15,1,11,7,0,0,54,704,Y
Birmingham 122D,E01008948,14,4,18,1103,Y,12,15,2,12,22,84,5,152,105,N
Birmingham 122E,E01008949,7,0,7,1518,Y,7,17,3,5,16,5,1,54,704,Y
Birmingham 123A,E01008977,25,2,27,781,Y,15,17,1,22,4,0,1,60,594,Y
Birmingham 123B,E01009109,43,1,44,343,Y,20,17,1,60,12,0,0,110,183,Y
Birmingham 123C,E01009119,33,6,39,449,Y,16,16,1,14,16,8,0,71,436,Y
Birmingham 123D,E01009120,30,2,32,621,Y,27,20,3,28,9,0,0,87,286,Y
Birmingham 124A,E01009162,72,5,77,75,Y,19,25,4,23,17,43,1,132,134,Y
Birmingham 124B,E01009207,14,1,15,1217,Y,9,20,0,5,27,1,0,62,554,Y
Birmingham 124C,E01009208,5,1,6,1556,Y,9,20,0,13,2,10,0,54,704,Y
Birmingham 124D,E01009209,45,1,46,311,Y,18,35,1,23,4,18,1,100,211,Y
Birmingham 124E,E01009213,33,3,36,529,Y,11,23,2,16,5,5,0,62,554,Y
Birmingham 125B,E01009155,15,1,16,1171,Y,7,14,0,31,7,0,0,59,618,Y
Birmingham 125D,E01009157,51,1,52,232,Y,5,21,0,20,5,1,0,52,757,Y
Birmingham 125E,E01009160,57,0,57,184,Y,11,12,0,41,5,0,0,69,456,Y
Birmingham 125F,E01009161,28,2,30,686,Y,15,16,1,13,7,3,0,55,681,Y
Birmingham 125G,E01033633,51,6,57,184,Y,15,47,0,27,9,0,0,98,232,Y
Birmingham 126A,E01009117,67,10,77,75,Y,21,22,1,18,13,1,1,77,371,Y
Birmingham 126B,E01009210,22,1,23,927,Y,8,15,1,20,5,14,1,64,521,Y
Birmingham 126C,E01009212,50,7,57,184,Y,20,13,1,20,14,14,4,86,294,Y
Birmingham 126D,E01009214,50,4,54,212,Y,16,21,0,25,11,0,0,73,422,Y
Birmingham 126E,E01009215,34,2,36,529,Y,12,10,1,15,8,0,0,46,903,Y
Birmingham 127A,E01009108,8,0,8,1484,Y,9,12,0,2,2,0,0,25,1442,Y
Birmingham 127B,E01009111,26,0,26,817,Y,10,16,1,11,7,9,0,54,704,Y
Birmingham 127C,E01009112,23,0,23,927,Y,11,20,0,17,4,0,1,53,731,Y
Birmingham 127D,E01009116,21,3,24,885,Y,7,27,2,12,28,2,0,78,356,Y
Birmingham 127E,E01009118,13,1,14,1251,Y,5,13,1,24,3,1,0,47,883,Y
Birmingham 128A,E01009107,26,4,30,686,Y,17,9,2,20,4,1,0,53,731,Y
Birmingham 128B,E01009110,73,1,74,93,Y,12,15,0,22,5,0,1,55,681,Y
Birmingham 128C,E01009113,32,4,36,529,Y,16,10,3,23,8,3,0,63,538,Y
Birmingham 128D,E01009114,36,3,39,449,Y,18,12,1,23,6,1,0,61,573,Y
Birmingham 128E,E01009115,24,1,25,848,Y,14,16,1,17,10,0,0,58,635,Y
Birmingham 129A,E01009158,27,2,29,716,Y,12,27,2,9,6,7,0,63,538,Y
Birmingham 129B,E01009163,37,1,38,475,Y,16,16,1,20,6,0,2,61,573,Y
Birmingham 129C,E01009165,46,1,47,291,Y,20,29,5,27,8,0,0,89,275,Y
Birmingham 129D,E01009169,26,1,27,781,Y,4,15,1,14,6,1,0,41,1044,Y
Birmingham 130A,E01009159,41,7,48,276,Y,13,65,3,21,108,27,5,242,44,N
Birmingham 130B,E01009164,14,1,15,1217,Y,5,12,0,7,2,0,0,26,1420,Y
Birmingham 130C,E01009167,22,2,24,885,Y,17,12,1,22,3,0,0,55,681,Y
Birmingham 130D,E01009171,20,1,21,989,Y,11,14,1,17,2,0,0,45,929,Y
Birmingham 131A,E01009166,13,2,15,1217,Y,4,10,0,5,1,29,0,49,830,Y
Birmingham 131B,E01009168,10,1,11,1355,Y,5,10,0,5,2,0,0,22,1509,Y
Birmingham 131C,E01009170,13,1,14,1251,Y,7,36,0,7,26,1,0,77,371,Y
Birmingham 131D,E01009216,42,3,45,328,Y,25,27,2,43,10,24,0,131,139,Y
Birmingham 131E,E01009217,9,0,9,1445,Y,9,9,1,7,3,0,1,30,1319,Y
Birmingham 132A,E01009039,8,0,8,1484,Y,5,22,0,2,2,0,0,31,1290,Y
Birmingham 132B,E01009040,7,1,8,1484,Y,3,17,0,3,3,0,2,28,1373,Y
Birmingham 132C,E01009041,11,2,13,1288,Y,13,11,0,9,3,0,0,36,1162,Y
Birmingham 132D,E01009042,9,2,11,1355,Y,4,16,0,7,3,0,0,30,1319,Y
Birmingham 132E,E01032589,26,3,29,716,Y,5,15,2,22,4,0,0,48,858,Y
Birmingham 133A,E01009262,19,2,21,989,Y,12,14,0,9,2,0,1,38,1115,Y
Birmingham 133B,E01009267,21,2,23,927,Y,8,11,0,5,2,0,1,27,1397,Y
Birmingham 133C,E01009276,14,1,15,1217,Y,7,6,0,5,2,0,1,21,1531,Y
Birmingham 133D,E01009278,27,2,29,716,Y,9,7,1,12,30,1,0,60,594,Y
Birmingham 133E,E01009279,19,0,19,1059,Y,11,6,0,7,2,0,0,26,1420,Y
Birmingham 133F,E01032591,17,1,18,1103,Y,9,7,0,8,3,1,0,28,1373,Y
Birmingham 134A,E01008995,77,9,86,52,Y,24,16,5,58,18,3,6,130,141,Y
Birmingham 134B,E01033557,154,18,172,12,N,23,35,12,33,67,2,59,231,49,N
Birmingham 134C,E01033624,14,0,14,1251,Y,15,16,2,8,4,0,0,45,929,Y
Birmingham 134D,E01033626,25,2,27,781,Y,3,4,2,8,3,0,2,22,1509,Y
Birmingham 134E,E01033640,64,33,97,35,Y,21,39,2,32,37,1,11,143,116,Y
Birmingham 135A,E01009378,111,29,140,17,N,27,140,4,44,58,0,18,291,31,N
Birmingham 135B,E01033567,53,13,66,123,Y,6,31,2,14,16,0,16,85,305,Y
Birmingham 135C,E01033615,457,66,523,3,N,39,71,40,89,260,440,225,1164,4,N
Birmingham 135D,E01033616,49,15,64,142,Y,4,39,2,20,29,1,13,108,187,Y
Birmingham 136A,E01009143,28,5,33,596,Y,14,18,2,19,6,0,1,60,594,Y
Birmingham 136B,E01009146,155,15,170,13,N,23,75,22,26,151,20,46,363,20,Y
Birmingham 136C,E01033564,15,2,17,1137,Y,9,23,3,3,4,0,0,42,1014,Y
Birmingham 136D,E01033639,214,40,254,6,N,11,63,6,45,94,1,66,286,32,N
Birmingham 137A,E01009141,77,13,90,47,Y,11,29,7,17,208,87,4,363,20,Y
Birmingham 137B,E01033565,22,2,24,885,Y,9,59,10,18,19,45,6,166,87,Y
Birmingham 137C,E01033618,7,4,11,1355,Y,0,6,3,4,2,0,1,16,1608,Y
Birmingham 137D,E01033619,31,5,36,529,Y,25,33,4,15,11,2,5,95,246,Y
Birmingham 137E,E01033627,78,13,91,44,Y,14,50,20,26,74,1,98,283,34,N
Birmingham 138A,E01033620,481,98,579,2,N,81,60,76,94,377,1332,234,2254,1,N
Birmingham 138B,E01033622,45,11,56,191,Y,18,74,7,20,20,0,11,150,109,N
Birmingham 138C,E01033623,50,16,66,123,Y,21,110,8,29,21,14,10,213,57,Y
Birmingham 138D,E01033625,58,8,66,123,Y,9,26,17,22,54,90,28,246,43,N
Birmingham 139A,E01009200,132,28,160,15,N,52,148,7,57,102,21,61,448,12,N
Birmingham 139B,E01009327,10,1,11,1355,Y,1,4,0,3,1,0,0,9,1671,Y
Birmingham 139C,E01009328,29,0,29,716,Y,9,15,1,14,3,0,1,43,992,Y
Birmingham 139D,E01009331,30,2,32,621,Y,2,12,0,20,9,0,1,44,958,Y
Birmingham 139E,E01009332,91,14,105,27,N,17,50,3,33,103,104,3,313,28,N
Birmingham 139F,E01009333,18,3,21,989,Y,5,4,0,12,0,9,1,31,1290,Y
Birmingham 139G,E01009335,55,8,63,150,Y,6,28,2,19,42,60,6,163,91,Y
Birmingham 139H,E01009344,36,10,46,311,Y,5,18,0,16,5,1,0,45,929,Y
Birmingham 140A,E01009339,34,6,40,425,Y,3,30,2,26,9,0,0,70,445,Y
Birmingham 140B,E01009340,42,10,52,232,Y,12,30,1,24,9,0,2,78,356,Y
Birmingham 140C,E01009382,42,14,56,191,Y,14,12,3,23,13,0,3,68,469,Y
Birmingham 140D,E01009391,26,4,30,686,Y,13,9,1,12,31,6,1,73,422,Y
Birmingham 140E,E01009392,17,1,18,1103,Y,5,7,2,6,3,0,0,23,1483,Y
Birmingham 140F,E01009393,27,2,29,716,Y,2,6,0,5,5,2,0,20,1545,Y
Birmingham 140G,E01033641,43,9,52,232,Y,14,15,0,6,11,0,3,49,830,Y
Bromsgrove 001B,E01032139,0,0,0,1693,Y,1,0,0,0,0,0,0,1,1698,Y
Bromsgrove 002D,E01032169,0,0,0,1693,Y,0,0,0,0,0,0,0,0,1708,Y
Bromsgrove 003C,E01032171,2,0,2,1666,Y,0,0,0,5,0,0,0,5,1686,N
Bromsgrove 003D,E01032172,0,0,0,1693,Y,0,0,0,3,0,0,0,3,1692,Y
Bromsgrove 004C,E01032145,2,0,2,1666,Y,2,4,0,0,2,0,1,9,1671,Y
Bromsgrove 005A,E01032134,2,0,2,1666,Y,2,0,0,2,0,0,0,4,1687,Y
Bromsgrove 006A,E01032142,0,0,0,1693,Y,0,0,0,0,0,0,0,0,1708,Y
Coventry 001A,E01009589,35,1,36,529,Y,12,12,2,15,11,0,8,60,594,Y
Coventry 001F,E01032536,29,0,29,716,Y,16,11,3,19,4,3,0,56,668,Y
Coventry 001G,E01032537,33,0,33,596,Y,9,5,0,17,2,0,0,33,1242,Y
Coventry 001H,E01032538,64,2,66,123,Y,19,32,5,28,8,1,1,94,252,Y
Coventry 002A,E01009590,22,0,22,965,Y,35,23,0,11,6,8,0,83,320,Y
Coventry 002B,E01009591,22,1,23,927,Y,9,9,1,16,1,0,0,36,1162,Y
Coventry 002C,E01009593,25,3,28,751,Y,8,8,0,13,8,6,2,45,929,Y
Coventry 002D,E01009598,10,1,11,1355,Y,11,9,1,4,4,0,0,29,1346,Y
Coventry 004A,E01009604,32,0,32,621,Y,15,20,0,25,1,0,0,61,573,Y
Coventry 004B,E01009605,23,1,24,885,Y,13,10,1,9,4,1,0,38,1115,Y
Coventry 004C,E01009607,79,5,84,59,Y,21,17,6,39,19,16,1,119,166,N
Coventry 004D,E01009608,25,0,25,848,Y,14,10,1,11,4,0,0,40,1076,Y
Coventry 004E,E01009610,32,3,35,554,Y,8,12,0,8,7,0,0,35,1190,Y
Coventry 005A,E01009564,43,0,43,361,Y,22,16,1,13,15,1,0,68,469,Y
Coventry 005B,E01009575,39,2,41,405,Y,5,9,7,19,14,127,2,183,72,Y
Coventry 005C,E01009606,12,1,13,1288,Y,11,9,5,10,7,0,0,42,1014,Y
Coventry 005D,E01009609,18,4,22,965,Y,24,4,1,15,10,0,0,54,704,Y
Coventry 006A,E01009524,20,1,21,989,Y,13,13,1,13,23,6,1,70,445,Y
Coventry 006B,E01009525,19,0,19,1059,Y,9,10,0,9,2,0,1,31,1290,Y
Coventry 006C,E01009527,27,3,30,686,Y,14,14,0,15,1,5,0,49,830,Y
Coventry 006D,E01009594,5,0,5,1592,Y,10,6,2,11,2,0,0,31,1290,Y
Coventry 007A,E01009577,52,3,55,202,Y,39,14,3,32,16,0,2,106,192,Y
Coventry 007B,E01009579,67,9,76,80,Y,11,16,5,78,4,3,1,118,167,Y
Coventry 007C,E01009581,35,5,40,425,Y,15,15,4,56,8,29,0,127,149,N
Coventry 007D,E01009584,14,1,15,1217,Y,12,16,0,8,4,1,0,41,1044,Y
Coventry 007E,E01009585,42,1,43,361,Y,19,11,1,34,3,0,1,69,456,Y
Coventry 007F,E01009709,58,4,62,156,Y,25,15,3,29,11,0,2,85,305,Y
Coventry 008A,E01009576,29,1,30,686,Y,21,11,0,9,2,0,0,43,992,Y
Coventry 008B,E01009578,15,1,16,1171,Y,15,40,1,13,13,35,1,118,167,Y
Coventry 008C,E01009582,25,1,26,817,Y,16,9,2,14,11,6,0,58,635,Y
Coventry 008D,E01009583,16,3,19,1059,Y,23,21,1,13,56,102,2,218,53,Y
Coventry 008E,E01009586,12,0,12,1319,Y,16,18,0,15,1,2,0,52,757,Y
Coventry 009A,E01009565,16,0,16,1171,Y,6,7,2,3,4,1,0,23,1483,Y
Coventry 009B,E01009566,62,5,67,116,Y,31,19,2,20,30,6,2,110,183,Y
Coventry 009C,E01009567,47,1,48,276,Y,28,28,5,20,26,14,5,126,150,Y
Coventry 009D,E01009568,34,1,35,554,Y,17,18,2,12,3,1,1,54,704,Y
Coventry 010A,E01009523,14,0,14,1251,Y,18,19,0,5,6,0,0,48,858,Y
Coventry 010B,E01009526,33,2,35,554,Y,19,20,0,8,9,1,2,59,618,Y
Coventry 010C,E01009528,13,1,14,1251,Y,14,19,0,5,4,0,0,42,1014,Y
Coventry 010D,E01009531,18,1,19,1059,Y,11,6,1,9,5,3,0,35,1190,Y
Coventry 011A,E01009587,36,1,37,496,Y,18,16,0,19,9,1,1,64,521,Y
Coventry 011B,E01009624,47,2,49,269,Y,22,8,2,16,12,86,2,148,110,Y
Coventry 011C,E01009625,31,1,32,621,Y,14,8,1,15,1,1,0,40,1076,Y
Coventry 011D,E01009626,32,1,33,596,Y,17,12,1,16,3,0,0,49,830,Y
Coventry 012A,E01009622,39,1,40,425,Y,13,4,2,21,7,3,0,50,805,Y
Coventry 012B,E01009623,36,1,37,496,Y,16,8,1,16,1,0,1,43,992,Y
Coventry 012C,E01009627,45,2,47,291,Y,14,8,2,41,9,8,1,83,320,Y
Coventry 012D,E01009628,35,4,39,449,Y,20,9,0,22,2,0,0,53,731,Y
Coventry 013A,E01009599,19,1,20,1025,Y,9,10,7,12,7,1,0,46,903,Y
Coventry 013B,E01009663,14,0,14,1251,Y,10,7,0,4,3,0,0,24,1462,Y
Coventry 013C,E01009710,11,0,11,1355,Y,21,12,2,13,5,21,0,74,414,Y
Coventry 013D,E01009711,17,2,19,1059,Y,13,13,1,10,5,4,0,46,903,Y
Coventry 014A,E01009522,16,0,16,1171,Y,6,8,1,10,2,4,0,31,1290,Y
Coventry 014B,E01009529,12,0,12,1319,Y,9,5,0,9,2,0,0,25,1442,Y
Coventry 014C,E01009530,7,0,7,1518,Y,2,5,0,2,0,0,0,9,1671,Y
Coventry 014D,E01009645,9,0,9,1445,Y,1,12,0,4,0,0,0,17,1593,Y
Coventry 015A,E01009569,36,0,36,529,Y,9,12,1,16,11,110,3,162,95,Y
Coventry 015B,E01009570,79,10,89,50,N,17,18,3,24,16,4,9,91,263,Y
Coventry 015C,E01009571,34,1,35,554,Y,10,16,3,16,8,2,0,55,681,Y
Coventry 015D,E01009572,62,6,68,110,Y,25,25,10,39,13,2,3,117,172,Y
Coventry 015E,E01009573,22,3,25,848,Y,9,7,0,11,2,0,0,29,1346,Y
Coventry 015F,E01009574,53,5,58,179,Y,4,12,12,16,20,12,2,78,356,Y
Coventry 016A,E01009655,45,1,46,311,Y,16,15,2,28,8,4,0,73,422,Y
Coventry 016B,E01009656,39,2,41,405,Y,12,26,3,22,10,1,1,75,400,Y
Coventry 016C,E01009659,39,3,42,391,Y,7,10,8,11,12,0,0,48,858,Y
Coventry 016D,E01009662,37,4,41,405,Y,16,20,10,12,26,30,3,117,172,Y
Coventry 016E,E01009664,29,3,32,621,Y,20,5,1,7,2,0,0,35,1190,Y
Coventry 017A,E01009643,7,1,8,1484,Y,0,4,1,9,3,10,1,28,1373,Y
Coventry 017B,E01009644,8,0,8,1484,Y,7,13,0,2,0,0,0,22,1509,Y
Coventry 017C,E01009647,33,2,35,554,Y,14,21,2,49,53,37,7,183,72,Y
Coventry 017D,E01009648,15,0,15,1217,Y,8,16,1,7,1,0,0,33,1242,Y
Coventry 017E,E01009652,10,0,10,1405,Y,2,9,1,1,1,0,0,14,1634,Y
Coventry 017F,E01009653,10,1,11,1355,Y,5,7,0,9,1,0,0,22,1509,Y
Coventry 018A,E01009613,11,1,12,1319,Y,7,9,0,5,4,0,0,25,1442,Y
Coventry 018B,E01009657,22,3,25,848,Y,11,13,0,11,15,3,0,53,731,Y
Coventry 018C,E01009712,73,3,76,80,Y,15,17,6,29,29,1,3,100,211,Y
Coventry 018D,E01009714,18,0,18,1103,Y,15,12,2,7,4,0,0,40,1076,Y
Coventry 018E,E01009716,37,0,37,496,Y,18,10,4,11,5,3,0,51,782,Y
Coventry 019A,E01009580,73,2,75,88,Y,7,6,5,26,16,1,0,61,573,Y
Coventry 019B,E01009713,15,1,16,1171,Y,17,17,1,27,10,26,0,98,232,Y
Coventry 019C,E01009715,22,1,23,927,Y,7,13,0,7,2,0,0,29,1346,Y
Coventry 019D,E01009717,9,3,12,1319,Y,16,13,3,15,17,13,1,78,356,Y
Coventry 019E,E01009718,61,2,63,150,Y,18,8,0,22,2,3,0,53,731,Y
Coventry 020A,E01009629,66,2,68,110,Y,31,42,5,24,9,1,0,112,181,N
Coventry 020B,E01009630,50,1,51,248,Y,10,9,0,22,4,0,0,45,929,Y
Coventry 020C,E01009631,32,0,32,621,Y,11,6,1,27,7,1,0,53,731,Y
Coventry 020D,E01009632,66,6,72,97,Y,21,26,3,28,17,5,0,100,211,Y
Coventry 020E,E01009650,37,7,44,343,Y,58,28,4,20,8,0,0,118,167,Y
Coventry 021A,E01009614,11,0,11,1355,Y,9,5,1,14,1,4,0,34,1219,Y
Coventry 021B,E01009654,12,0,12,1319,Y,11,9,2,8,0,0,0,30,1319,Y
Coventry 021C,E01009658,11,1,12,1319,Y,22,3,0,8,0,0,0,33,1242,Y
Coventry 021D,E01009660,36,2,38,475,Y,20,14,5,29,8,9,3,88,277,Y
Coventry 022A,E01009646,17,1,18,1103,Y,15,15,0,15,3,0,0,48,858,Y
Coventry 022B,E01009692,2,1,3,1651,Y,11,1,0,3,1,0,0,16,1608,Y
Coventry 022C,E01009693,8,1,9,1445,Y,4,4,0,7,1,0,0,16,1608,Y
Coventry 022D,E01009694,10,1,11,1355,Y,11,7,0,4,1,3,0,26,1420,Y
Coventry 023A,E01009695,9,1,10,1405,Y,7,9,0,12,3,0,1,32,1265,Y
Coventry 023B,E01009696,10,0,10,1405,Y,3,11,0,3,1,0,0,18,1572,Y
Coventry 023C,E01009704,10,0,10,1405,Y,4,39,0,5,5,5,0,58,635,Y
Coventry 023D,E01009705,9,0,9,1445,Y,11,14,0,5,3,3,0,36,1162,Y
Coventry 024A,E01009636,42,11,53,217,Y,19,13,4,23,6,0,0,65,504,Y
Coventry 024B,E01009637,30,1,31,655,Y,5,10,2,8,2,2,1,30,1319,Y
Coventry 024C,E01009638,167,30,197,10,N,20,42,23,42,55,2,33,217,55,Y
Coventry 024D,E01009639,45,2,47,291,Y,23,18,3,19,5,6,1,75,400,Y
Coventry 024E,E01009640,49,2,51,248,Y,20,10,4,30,9,0,0,73,422,Y
Coventry 024F,E01009641,59,17,76,80,Y,34,25,9,36,17,2,6,129,143,Y
Coventry 025A,E01009697,10,1,11,1355,Y,14,10,0,5,6,0,0,35,1190,Y
Coventry 025B,E01009698,5,0,5,1592,Y,7,6,0,4,1,0,0,18,1572,Y
Coventry 025C,E01009703,34,4,38,475,Y,16,26,2,30,11,20,0,105,197,Y
Coventry 025D,E01009706,5,0,5,1592,Y,4,10,0,2,2,0,0,18,1572,Y
Coventry 026A,E01009649,15,1,16,1171,Y,8,12,0,5,1,8,1,35,1190,Y
Coventry 026B,E01009684,18,2,20,1025,Y,7,11,2,18,3,0,0,41,1044,Y
Coventry 026C,E01009685,6,0,6,1556,Y,9,7,0,7,0,0,0,23,1483,Y
Coventry 026D,E01009686,39,1,40,425,Y,25,20,8,32,33,15,1,134,129,Y
Coventry 026E,E01009687,5,2,7,1518,Y,6,14,0,13,2,5,0,40,1076,Y
Coventry 027A,E01009615,18,5,23,927,Y,23,20,6,14,14,63,3,143,116,Y
Coventry 027B,E01009616,32,3,35,554,Y,16,11,5,20,7,2,1,62,554,Y
Coventry 027C,E01009617,13,1,14,1251,Y,6,8,1,7,7,2,0,31,1290,Y
Coventry 027D,E01009618,10,0,10,1405,Y,17,16,2,9,2,0,0,46,903,Y
Coventry 027E,E01009620,17,4,21,989,Y,30,11,1,19,0,0,0,61,573,Y
Coventry 027F,E01009621,19,2,21,989,Y,19,5,0,9,6,1,0,40,1076,Y
Coventry 028A,E01009633,31,4,35,554,Y,13,10,2,23,10,1,1,60,594,Y
Coventry 028B,E01009634,18,0,18,1103,Y,19,7,2,10,1,2,1,42,1014,Y
Coventry 028C,E01009635,84,14,98,32,Y,35,24,26,39,29,4,11,168,84,Y
Coventry 028D,E01009661,39,6,45,328,Y,18,12,4,18,13,0,5,70,445,Y
Coventry 029A,E01009674,35,1,36,529,Y,12,11,1,18,3,0,1,46,903,Y
Coventry 029B,E01009699,9,1,10,1405,Y,12,6,1,6,3,1,0,29,1346,Y
Coventry 029C,E01009700,50,0,50,257,Y,18,13,2,29,10,0,0,72,427,Y
Coventry 029D,E01009701,23,1,24,885,Y,8,4,0,6,5,0,0,23,1483,Y
Coventry 029E,E01009702,51,7,58,179,Y,12,15,1,23,9,5,1,66,490,Y
Coventry 030A,E01009688,15,0,15,1217,Y,37,18,3,9,7,0,3,77,371,Y
Coventry 030B,E01009689,34,3,37,496,Y,27,18,1,20,17,0,2,85,305,Y
Coventry 030C,E01009690,5,0,5,1592,Y,7,11,0,3,1,0,0,22,1509,Y
Coventry 030D,E01009691,8,3,11,1355,Y,24,14,4,4,4,1,0,51,782,Y
Coventry 031A,E01009548,33,2,35,554,Y,20,20,8,18,18,0,2,86,294,Y
Coventry 031B,E01009553,65,13,78,73,Y,30,47,9,29,30,79,2,226,52,N
Coventry 031C,E01009642,417,57,474,4,N,73,65,214,150,279,560,118,1459,2,N
Coventry 031D,E01009651,34,9,43,361,Y,29,20,4,28,11,1,1,94,252,Y
Coventry 032A,E01009676,9,1,10,1405,Y,13,4,0,6,2,0,0,25,1442,Y
Coventry 032B,E01009681,18,2,20,1025,Y,10,6,0,6,4,8,0,34,1219,Y
Coventry 032C,E01009682,14,0,14,1251,Y,8,8,1,6,2,1,0,26,1420,Y
Coventry 032D,E01009683,29,2,31,655,Y,18,13,2,12,8,4,1,58,635,Y
Coventry 033A,E01009532,2,0,2,1666,Y,9,11,0,15,3,0,0,38,1115,Y
Coventry 033B,E01009535,7,1,8,1484,Y,3,4,0,11,1,1,0,20,1545,Y
Coventry 033C,E01009536,10,1,11,1355,Y,6,22,0,2,2,2,0,34,1219,Y
Coventry 033D,E01009543,17,3,20,1025,Y,12,29,2,15,30,93,3,184,71,N
Coventry 033E,E01009707,13,0,13,1288,Y,6,9,1,11,1,0,0,28,1373,Y
Coventry 033F,E01009708,12,0,12,1319,Y,8,3,1,4,5,0,1,22,1509,Y
Coventry 034A,E01009554,6,0,6,1556,Y,6,8,2,10,3,0,0,29,1346,Y
Coventry 034B,E01009555,4,0,4,1626,Y,7,7,3,3,11,0,0,31,1290,Y
Coventry 034C,E01009556,19,1,20,1025,Y,11,20,2,12,6,30,0,81,340,Y
Coventry 034D,E01009557,12,4,16,1171,Y,8,18,0,11,23,13,1,74,414,Y
Coventry 034E,E01009558,12,0,12,1319,Y,7,13,4,3,1,0,0,28,1373,Y
Coventry 034F,E01009559,28,1,29,716,Y,12,4,1,9,4,0,0,30,1319,Y
Coventry 035C,E01009537,20,1,21,989,Y,13,10,1,11,10,39,0,84,314,Y
Coventry 035D,E01009538,24,0,24,885,Y,17,13,1,20,29,4,1,85,305,Y
Coventry 035E,E01009611,62,4,66,123,Y,14,12,1,31,5,35,2,100,211,Y
Coventry 035F,E01009612,22,2,24,885,Y,4,5,0,22,3,0,0,34,1219,Y
Coventry 035G,E01032527,24,0,24,885,Y,5,6,1,10,4,0,0,26,1420,Y
Coventry 035H,E01032528,15,0,15,1217,Y,8,6,1,8,3,0,0,26,1420,Y
Coventry 036C,E01009679,37,2,39,449,Y,12,12,3,24,8,2,2,63,538,Y
Coventry 036E,E01032531,75,1,76,80,Y,36,19,2,56,14,0,2,129,143,Y
Coventry 036F,E01032532,11,2,13,1288,Y,11,13,2,6,3,9,1,45,929,Y
Coventry 036G,E01032533,19,1,20,1025,Y,9,2,8,6,12,0,0,37,1139,Y
Coventry 037B,E01009549,5,2,7,1518,Y,7,10,0,11,3,2,1,34,1219,Y
Coventry 037C,E01009550,16,0,16,1171,Y,22,11,4,12,3,2,1,55,681,Y
Coventry 037E,E01009552,26,0,26,817,Y,14,11,0,8,3,0,0,36,1162,Y
Coventry 037F,E01032534,15,1,16,1171,Y,6,6,1,4,4,0,0,21,1531,Y
Coventry 037G,E01032535,4,1,5,1592,Y,7,11,2,7,2,6,0,35,1190,Y
Coventry 038A,E01009544,22,1,23,927,Y,14,10,1,12,8,0,2,47,883,Y
Coventry 038D,E01009619,64,4,68,110,Y,32,23,9,32,10,47,2,155,102,Y
Coventry 038E,E01032529,7,0,7,1518,Y,8,16,0,2,8,0,1,35,1190,Y
Coventry 038F,E01032530,23,2,25,848,Y,29,88,8,13,16,51,2,207,61,N
Coventry 039A,E01009539,46,0,46,311,Y,17,18,2,33,7,0,0,77,371,Y
Coventry 039B,E01009540,63,2,65,135,Y,14,7,2,26,7,7,1,64,521,Y
Coventry 039C,E01009541,19,0,19,1059,Y,18,12,0,21,19,17,1,88,277,Y
Coventry 039D,E01009542,36,5,41,405,Y,14,10,0,26,7,1,1,59,618,Y
Coventry 040A,E01009560,5,0,5,1592,Y,12,11,1,0,3,0,0,27,1397,Y
Coventry 040B,E01009561,17,0,17,1137,Y,1,8,0,4,1,0,1,15,1627,Y
Coventry 040C,E01009562,10,0,10,1405,Y,5,10,0,5,6,3,1,30,1319,Y
Coventry 040D,E01009563,3,0,3,1651,Y,4,14,0,2,1,1,0,22,1509,Y
Coventry 040E,E01009672,6,2,8,1484,Y,12,17,0,4,52,28,0,113,179,Y
Coventry 041A,E01009666,5,3,8,1484,Y,5,5,1,4,5,7,0,27,1397,Y
Coventry 041B,E01009667,13,0,13,1288,Y,6,7,0,9,0,0,0,22,1509,Y
Coventry 041C,E01009668,18,0,18,1103,Y,6,16,2,7,5,0,0,36,1162,Y
Coventry 041D,E01009670,4,0,4,1626,Y,2,7,0,7,1,0,0,17,1593,Y
Coventry 042A,E01009665,3,1,4,1626,Y,11,4,0,3,2,0,0,20,1545,Y
Coventry 042B,E01009669,4,0,4,1626,Y,5,9,0,2,0,0,0,16,1608,Y
Coventry 042C,E01009671,25,0,25,848,Y,21,8,26,3,33,1,3,95,246,Y
Coventry 042F,E01033058,20,4,24,885,Y,19,9,6,8,27,20,3,92,257,Y
Coventry 043A,E01009588,30,2,32,621,Y,11,7,3,8,4,2,1,36,1162,Y
Coventry 043B,E01009592,47,1,48,276,Y,15,14,1,47,5,0,0,82,330,Y
Coventry 043C,E01009596,22,0,22,965,Y,13,11,1,38,7,2,0,72,427,Y
Coventry 043D,E01009597,29,3,32,621,Y,17,16,2,7,48,1,0,91,263,Y
Coventry 043E,E01032587,22,0,22,965,Y,8,7,0,12,1,30,0,58,635,Y
Dudley 001A,E01009763,12,0,12,1319,Y,7,6,0,11,1,0,1,26,1420,Y
Dudley 001B,E01009764,20,3,23,927,Y,10,17,3,11,3,0,0,44,958,Y
Dudley 001C,E01009767,7,0,7,1518,Y,11,12,1,17,8,0,0,49,830,Y
Dudley 001D,E01009769,25,2,27,781,Y,23,21,2,17,6,0,0,69,456,Y
Dudley 001E,E01009770,19,1,20,1025,Y,9,21,1,9,7,3,0,50,805,Y
Dudley 002A,E01009773,27,2,29,716,Y,14,18,6,25,6,1,1,71,436,Y
Dudley 002B,E01009777,22,0,22,965,Y,9,8,0,8,7,0,0,32,1265,Y
Dudley 002C,E01009778,16,1,17,1137,Y,11,18,0,12,2,0,0,43,992,Y
Dudley 002D,E01009895,22,3,25,848,Y,17,14,2,7,11,10,2,63,538,Y
Dudley 003A,E01009896,9,2,11,1355,Y,17,7,0,8,5,0,0,37,1139,Y
Dudley 003B,E01009897,2,0,2,1666,Y,12,11,0,0,5,0,0,28,1373,Y
Dudley 003C,E01009898,13,1,14,1251,Y,10,12,1,13,2,31,4,73,422,Y
Dudley 003D,E01009901,8,2,10,1405,Y,7,1,0,1,8,0,1,18,1572,Y
Dudley 003E,E01009902,5,0,5,1592,Y,4,7,0,1,0,0,0,12,1656,Y
Dudley 004A,E01009765,9,0,9,1445,Y,4,11,1,8,1,0,0,25,1442,Y
Dudley 004B,E01009766,18,0,18,1103,Y,25,17,4,10,4,9,0,69,456,Y
Dudley 004C,E01009768,39,11,50,257,Y,16,22,5,21,31,16,0,111,182,N
Dudley 004D,E01009771,2,1,3,1651,Y,4,8,0,3,3,2,0,20,1545,Y
Dudley 004E,E01009775,12,0,12,1319,Y,11,11,2,9,3,0,0,36,1162,Y
Dudley 004F,E01009776,8,1,9,1445,Y,16,18,1,12,11,0,1,59,618,Y
Dudley 005A,E01009758,21,1,22,965,Y,8,6,0,27,1,3,0,45,929,Y
Dudley 005B,E01009760,11,0,11,1355,Y,1,6,0,11,2,0,0,20,1545,Y
Dudley 005C,E01009772,28,0,28,751,Y,7,10,2,8,5,0,0,32,1265,Y
Dudley 005D,E01009774,13,2,15,1217,Y,11,11,1,7,2,0,0,32,1265,Y
Dudley 005E,E01009788,22,1,23,927,Y,8,8,1,13,9,5,0,44,958,Y
Dudley 006B,E01009756,24,0,24,885,Y,4,5,1,7,5,0,1,23,1483,Y
Dudley 006C,E01009757,74,10,84,59,Y,44,60,8,33,75,122,14,356,23,N
Dudley 006D,E01009759,4,0,4,1626,Y,2,5,1,2,2,0,0,12,1656,Y
Dudley 006F,E01009762,37,1,38,475,Y,2,6,0,19,1,0,0,28,1373,Y
Dudley 006G,E01033187,78,0,78,73,Y,21,17,5,30,9,2,0,84,314,Y
Dudley 007A,E01009781,20,1,21,989,Y,5,16,0,18,8,2,0,49,830,Y
Dudley 007B,E01009786,24,1,25,848,Y,10,13,1,20,1,0,0,45,929,Y
Dudley 007C,E01009789,7,1,8,1484,Y,11,5,0,13,1,0,0,30,1319,Y
Dudley 007D,E01009790,28,2,30,686,Y,14,11,1,16,11,23,1,77,371,Y
Dudley 008A,E01009779,10,1,11,1355,Y,13,15,0,37,5,37,1,108,187,Y
Dudley 008B,E01009782,18,0,18,1103,Y,5,6,0,10,2,0,0,23,1483,Y
Dudley 008C,E01009783,27,0,27,781,Y,8,9,1,14,3,0,0,35,1190,Y
Dudley 008D,E01009785,5,0,5,1592,Y,10,7,0,9,5,0,1,32,1265,Y
Dudley 008E,E01009899,5,0,5,1592,Y,3,2,1,2,0,0,0,8,1678,Y
Dudley 008F,E01009900,7,0,7,1518,Y,4,3,0,9,0,0,0,16,1608,Y
Dudley 009A,E01009780,13,0,13,1288,Y,9,10,1,9,0,0,0,29,1346,Y
Dudley 009B,E01009784,10,1,11,1355,Y,14,10,0,17,1,21,0,63,538,Y
Dudley 009C,E01009787,11,3,14,1251,Y,7,8,0,3,4,0,1,23,1483,Y
Dudley 009D,E01009880,16,3,19,1059,Y,9,14,0,7,4,0,0,34,1219,Y
Dudley 009E,E01009882,23,1,24,885,Y,10,10,0,4,5,0,0,29,1346,Y
Dudley 010A,E01009891,27,0,27,781,Y,13,10,0,8,1,0,0,32,1265,Y
Dudley 010B,E01009892,94,16,110,23,Y,24,32,3,38,34,74,13,218,53,Y
Dudley 010C,E01009893,48,2,50,257,Y,12,38,2,20,50,0,0,122,156,Y
Dudley 010D,E01009894,25,2,27,781,Y,11,5,0,5,1,0,0,22,1509,Y
Dudley 011A,E01009844,28,3,31,655,Y,26,14,1,15,6,2,1,65,504,Y
Dudley 011B,E01009879,35,6,41,405,Y,25,25,2,19,18,3,0,92,257,Y
Dudley 011C,E01009881,96,10,106,26,N,68,50,2,54,40,31,6,251,42,N
Dudley 011D,E01009885,42,2,44,343,Y,11,16,1,14,7,2,1,52,757,Y
Dudley 012A,E01009816,9,1,10,1405,Y,20,21,1,8,10,0,1,61,573,Y
Dudley 012B,E01009817,2,0,2,1666,Y,3,4,1,3,3,0,0,14,1634,Y
Dudley 012C,E01009819,10,1,11,1355,Y,20,13,0,11,30,1,3,78,356,Y
Dudley 012D,E01009820,10,2,12,1319,Y,15,12,2,9,2,3,0,43,992,Y
Dudley 013A,E01009748,25,5,30,686,Y,24,8,0,17,5,8,0,62,554,Y
Dudley 013B,E01009839,19,0,19,1059,Y,9,13,1,8,5,0,0,36,1162,Y
Dudley 013C,E01009883,29,1,30,686,Y,11,7,2,11,4,31,0,66,490,Y
Dudley 013D,E01009884,64,0,64,142,Y,10,15,5,27,35,0,1,93,255,Y
Dudley 013E,E01009886,29,2,31,655,Y,11,10,0,14,7,0,0,42,1014,Y
Dudley 014A,E01009814,5,0,5,1592,Y,4,2,0,5,1,0,0,12,1656,Y
Dudley 014B,E01009815,5,0,5,1592,Y,6,10,1,6,4,0,0,27,1397,Y
Dudley 014C,E01009818,10,1,11,1355,Y,9,6,0,13,0,9,0,37,1139,Y
Dudley 014D,E01009821,5,0,5,1592,Y,3,7,0,7,0,0,0,17,1593,Y
Dudley 014E,E01009822,17,1,18,1103,Y,15,12,0,6,6,40,3,82,330,Y
Dudley 015A,E01009887,30,4,34,584,Y,25,14,0,21,8,9,2,79,349,Y
Dudley 015B,E01009888,13,2,15,1217,Y,3,9,0,9,1,0,0,22,1509,Y
Dudley 015C,E01009889,74,11,85,56,Y,24,28,4,30,43,33,7,169,83,N
Dudley 015D,E01009890,34,3,37,496,Y,8,8,2,23,5,0,0,46,903,Y
Dudley 016A,E01009749,24,0,24,885,Y,22,28,0,8,5,12,0,75,400,Y
Dudley 016B,E01009750,9,0,9,1445,Y,22,14,0,13,5,0,1,55,681,Y
Dudley 016C,E01009823,3,0,3,1651,Y,16,9,0,8,12,0,0,45,929,Y
Dudley 016D,E01009824,11,0,11,1355,Y,7,19,0,13,11,0,0,50,805,Y
Dudley 017A,E01009751,19,0,19,1059,Y,14,7,1,8,5,0,0,35,1190,Y
Dudley 017B,E01009752,29,3,32,621,Y,35,2,0,22,8,18,2,87,286,Y
Dudley 017C,E01009753,31,1,32,621,Y,23,10,3,15,3,0,0,54,704,Y
Dudley 017D,E01009754,43,2,45,328,Y,23,20,2,16,14,26,1,102,202,Y
Dudley 017E,E01009841,52,3,55,202,Y,25,26,3,17,6,6,0,83,320,Y
Dudley 018A,E01009840,44,1,45,328,Y,38,15,3,16,5,5,1,83,320,Y
Dudley 018B,E01009842,38,0,38,475,Y,24,21,0,23,7,1,2,78,356,Y
Dudley 018C,E01009843,24,10,34,584,Y,26,23,1,25,16,1,0,92,257,Y
Dudley 018D,E01009871,23,0,23,927,Y,8,11,2,11,17,1,0,50,805,Y
Dudley 018E,E01009875,30,2,32,621,Y,6,15,5,7,5,7,1,46,903,Y
Dudley 019A,E01009825,23,1,24,885,Y,5,3,0,6,3,0,1,18,1572,Y
Dudley 019B,E01009826,7,0,7,1518,Y,9,3,0,2,1,0,0,15,1627,Y
Dudley 019C,E01009827,5,1,6,1556,Y,3,7,0,1,1,0,0,12,1656,Y
Dudley 019D,E01009828,10,1,11,1355,Y,12,2,1,4,3,6,0,28,1373,Y
Dudley 019E,E01009829,4,0,4,1626,Y,9,8,0,26,1,0,0,44,958,Y
Dudley 019F,E01009830,2,0,2,1666,Y,6,4,0,2,1,0,0,13,1649,Y
Dudley 020A,E01009872,34,6,40,425,Y,17,6,2,31,4,0,0,60,594,Y
Dudley 020B,E01009873,18,0,18,1103,Y,16,6,1,14,3,0,1,41,1044,Y
Dudley 020C,E01009874,26,1,27,781,Y,7,9,0,18,6,2,0,42,1014,Y
Dudley 020D,E01009876,32,3,35,554,Y,9,16,1,12,5,21,0,64,521,Y
Dudley 020E,E01009877,25,3,28,751,Y,12,12,1,17,6,1,0,49,830,Y
Dudley 021A,E01009911,6,1,7,1518,Y,2,4,0,2,0,0,0,8,1678,Y
Dudley 021B,E01009912,6,2,8,1484,Y,8,7,0,2,1,0,0,18,1572,Y
Dudley 021C,E01009913,8,1,9,1445,Y,11,9,0,14,0,9,0,43,992,Y
Dudley 021D,E01009914,4,1,5,1592,Y,6,3,0,3,0,6,0,18,1572,Y
Dudley 021E,E01009915,20,0,20,1025,Y,15,9,1,10,12,0,0,47,883,Y
Dudley 021F,E01009916,13,1,14,1251,Y,9,6,2,9,3,22,0,51,782,Y
Dudley 022A,E01009741,101,17,118,21,N,28,83,2,56,77,482,27,755,7,N
Dudley 022B,E01009744,87,6,93,41,Y,38,36,7,44,13,62,6,206,62,Y
Dudley 022C,E01009746,73,6,79,70,Y,27,26,1,27,35,2,2,120,162,Y
Dudley 022D,E01009747,32,0,32,621,Y,31,23,2,22,7,0,1,86,294,Y
Dudley 023A,E01009731,12,2,14,1251,Y,15,23,1,8,3,1,0,51,782,Y
Dudley 023B,E01009740,24,3,27,781,Y,31,24,3,8,13,47,0,126,150,Y
Dudley 023C,E01009742,13,1,14,1251,Y,10,14,1,9,1,0,2,37,1139,Y
Dudley 023D,E01009743,33,1,34,584,Y,28,12,0,24,10,1,0,75,400,Y
Dudley 023E,E01009745,8,3,11,1355,Y,8,14,0,11,3,2,2,40,1076,Y
Dudley 024A,E01009917,2,2,4,1626,Y,1,2,0,0,0,0,0,3,1692,Y
Dudley 024B,E01009918,13,2,15,1217,Y,5,8,1,8,1,0,1,24,1462,Y
Dudley 024C,E01009919,4,0,4,1626,Y,2,4,0,3,0,0,0,9,1671,Y
Dudley 024D,E01009920,7,0,7,1518,Y,3,14,0,4,6,1,0,28,1373,Y
Dudley 025A,E01009864,33,2,35,554,Y,7,17,4,11,8,44,0,91,263,Y
Dudley 025B,E01009865,19,2,21,989,Y,5,12,0,9,3,2,1,32,1265,Y
Dudley 025C,E01009866,24,2,26,817,Y,9,15,3,24,6,1,0,58,635,Y
Dudley 025D,E01009867,11,0,11,1355,Y,18,14,1,15,4,2,1,55,681,Y
Dudley 025E,E01009878,17,4,21,989,Y,7,17,0,13,4,0,0,41,1044,Y
Dudley 026A,E01009791,7,3,10,1405,Y,5,5,0,3,0,0,0,13,1649,Y
Dudley 026B,E01009792,19,0,19,1059,Y,18,15,0,9,0,0,0,42,1014,Y
Dudley 026C,E01009795,17,1,18,1103,Y,18,18,0,11,3,2,1,53,731,Y
Dudley 026D,E01009796,19,6,25,848,Y,17,14,0,6,4,0,0,41,1044,Y
Dudley 026E,E01009798,20,1,21,989,Y,20,17,0,11,6,1,1,56,668,Y
Dudley 027A,E01009719,13,0,13,1288,Y,3,16,1,11,0,0,0,31,1290,Y
Dudley 027B,E01009722,8,0,8,1484,Y,2,5,1,2,0,0,1,11,1665,Y
Dudley 027C,E01009727,3,3,6,1556,Y,8,9,0,2,2,7,0,28,1373,Y
Dudley 027D,E01009728,4,0,4,1626,Y,12,9,0,6,1,0,0,28,1373,Y
Dudley 027E,E01009729,13,1,14,1251,Y,13,21,2,9,4,0,0,49,830,Y
Dudley 028A,E01009720,1,1,2,1666,Y,6,2,0,5,1,0,0,14,1634,Y
Dudley 028B,E01009723,6,1,7,1518,Y,3,8,0,4,30,37,1,83,320,Y
Dudley 028C,E01009724,11,0,11,1355,Y,4,10,0,5,1,0,0,20,1545,Y
Dudley 028D,E01009730,10,0,10,1405,Y,10,13,1,1,5,0,1,31,1290,Y
Dudley 029A,E01009903,7,0,7,1518,Y,7,5,0,3,0,0,0,15,1627,Y
Dudley 029B,E01009904,8,1,9,1445,Y,6,11,0,6,2,0,1,26,1420,Y
Dudley 029C,E01009909,15,2,17,1137,Y,4,14,0,4,3,18,1,44,958,Y
Dudley 029D,E01009910,14,1,15,1217,Y,8,9,0,10,4,0,1,32,1265,Y
Dudley 030A,E01009793,7,1,8,1484,Y,10,14,0,2,3,0,0,29,1346,Y
Dudley 030B,E01009794,12,0,12,1319,Y,5,10,1,5,2,0,0,23,1483,Y
Dudley 030C,E01009797,14,3,17,1137,Y,14,15,1,14,7,1,0,52,757,Y
Dudley 030D,E01009801,14,6,20,1025,Y,13,39,0,4,6,56,0,118,167,Y
Dudley 031A,E01009721,28,3,31,655,Y,16,11,0,11,4,0,2,44,958,Y
Dudley 031B,E01009725,17,0,17,1137,Y,11,4,1,13,0,0,1,30,1319,Y
Dudley 031C,E01009726,10,0,10,1405,Y,5,6,0,4,4,0,1,20,1545,Y
Dudley 031D,E01009834,21,3,24,885,Y,17,23,0,11,7,32,0,90,269,Y
Dudley 032A,E01009833,35,2,37,496,Y,50,37,1,25,7,3,0,123,155,N
Dudley 032B,E01009835,28,3,31,655,Y,10,14,1,6,9,0,1,41,1044,Y
Dudley 032C,E01009869,6,1,7,1518,Y,12,21,0,3,1,0,0,37,1139,Y
Dudley 032D,E01009870,7,0,7,1518,Y,12,18,0,4,6,0,0,40,1076,Y
Dudley 033A,E01009809,29,3,32,621,Y,8,15,0,21,4,0,0,48,858,Y
Dudley 033B,E01009813,15,0,15,1217,Y,5,8,1,4,3,0,0,21,1531,Y
Dudley 033C,E01009861,25,0,25,848,Y,7,9,0,5,1,3,0,25,1442,Y
Dudley 033D,E01009862,37,0,37,496,Y,26,12,1,14,9,0,0,62,554,Y
Dudley 033E,E01009863,19,0,19,1059,Y,8,7,1,12,3,0,0,31,1290,Y
Dudley 033F,E01009868,19,1,20,1025,Y,8,17,0,5,5,0,0,35,1190,Y
Dudley 034A,E01009734,52,5,57,184,Y,26,26,1,22,44,12,1,132,134,Y
Dudley 034B,E01009735,6,0,6,1556,Y,9,9,0,6,0,0,0,24,1462,Y
Dudley 034C,E01009736,13,1,14,1251,Y,8,13,1,3,1,0,0,26,1420,Y
Dudley 034D,E01009737,7,0,7,1518,Y,5,19,0,7,2,0,1,34,1219,Y
Dudley 034E,E01009738,13,2,15,1217,Y,1,10,0,0,3,0,0,14,1634,Y
Dudley 035A,E01009856,99,3,102,29,Y,29,30,3,67,55,178,23,385,17,N
Dudley 035B,E01009905,24,3,27,781,Y,13,10,1,13,8,24,2,71,436,Y
Dudley 035C,E01009906,27,1,28,751,Y,13,12,3,13,13,21,1,76,387,Y
Dudley 035D,E01009907,7,0,7,1518,Y,16,14,0,9,3,0,0,42,1014,Y
Dudley 035E,E01009908,7,1,8,1484,Y,6,10,0,16,1,0,0,33,1242,Y
Dudley 036A,E01009800,11,2,13,1288,Y,12,18,1,9,3,0,0,43,992,Y
Dudley 036B,E01009802,18,3,21,989,Y,11,13,0,6,1,0,0,31,1290,Y
Dudley 036C,E01009803,4,0,4,1626,Y,13,23,0,7,0,0,0,43,992,Y
Dudley 036D,E01009804,6,3,9,1445,Y,6,10,0,2,24,6,0,48,858,Y
Dudley 037A,E01009831,23,0,23,927,Y,6,11,0,11,1,0,0,29,1346,Y
Dudley 037B,E01009836,72,4,76,80,Y,33,35,1,24,30,10,1,134,129,Y
Dudley 037C,E01009837,30,1,31,655,Y,13,30,0,7,29,5,1,85,305,Y
Dudley 037D,E01009838,25,2,27,781,Y,3,7,1,10,1,18,0,40,1076,Y
Dudley 038A,E01009847,6,0,6,1556,Y,2,3,0,1,3,0,0,9,1671,Y
Dudley 038B,E01009848,17,0,17,1137,Y,10,5,1,16,3,22,0,57,656,Y
Dudley 038C,E01009849,23,0,23,927,Y,4,6,1,8,4,0,0,23,1483,Y
Dudley 038D,E01009851,2,0,2,1666,Y,3,9,1,3,4,1,0,21,1531,Y
Dudley 039A,E01009732,21,3,24,885,Y,10,8,0,17,6,1,1,43,992,Y
Dudley 039B,E01009733,63,3,66,123,Y,20,8,0,25,20,80,4,157,98,Y
Dudley 039C,E01009739,12,0,12,1319,Y,5,9,0,5,1,7,0,27,1397,Y
Dudley 039D,E01009799,4,0,4,1626,Y,0,7,1,4,3,3,0,18,1572,Y
Dudley 039E,E01009805,29,1,30,686,Y,11,30,0,18,31,35,3,128,147,Y
Dudley 039F,E01009806,5,1,6,1556,Y,5,6,0,8,5,0,1,25,1442,Y
Dudley 040A,E01009854,3,0,3,1651,Y,5,7,0,1,1,0,0,14,1634,Y
Dudley 040B,E01009857,11,0,11,1355,Y,11,6,0,12,2,0,0,31,1290,Y
Dudley 040C,E01009858,28,3,31,655,Y,13,10,0,26,12,6,3,70,445,Y
Dudley 040D,E01009859,4,2,6,1556,Y,5,7,0,2,1,0,1,16,1608,Y
Dudley 041A,E01009845,4,0,4,1626,Y,3,4,0,9,14,0,0,30,1319,Y
Dudley 041B,E01009846,9,1,10,1405,Y,9,2,0,1,3,20,0,35,1190,Y
Dudley 041C,E01009850,5,1,6,1556,Y,13,18,2,15,23,6,0,77,371,Y
Dudley 041D,E01009852,5,1,6,1556,Y,4,3,0,5,2,0,0,14,1634,Y
Dudley 042A,E01009832,21,0,21,989,Y,8,5,0,16,13,4,0,46,903,Y
Dudley 042B,E01009853,6,1,7,1518,Y,3,3,0,4,2,1,0,13,1649,Y
Dudley 042C,E01009855,5,0,5,1592,Y,6,7,0,1,1,0,1,16,1608,Y
Dudley 042D,E01009860,12,1,13,1288,Y,3,4,0,6,1,0,0,14,1634,Y
Dudley 043A,E01009807,3,0,3,1651,Y,4,7,0,11,2,0,0,24,1462,Y
Dudley 043B,E01009808,0,0,0,1693,Y,2,10,0,2,0,0,0,14,1634,Y
Dudley 043C,E01009810,10,0,10,1405,Y,4,9,0,9,3,3,0,28,1373,Y
Dudley 043D,E01009811,8,0,8,1484,Y,0,5,0,5,4,0,0,14,1634,Y
Dudley 043E,E01009812,11,0,11,1355,Y,4,7,0,4,2,0,0,17,1593,Y
Lichfield 006E,E01029497,2,0,2,1666,Y,0,1,0,1,1,0,0,3,1692,Y
Lichfield 009E,E01029505,0,0,0,1693,Y,0,1,0,0,0,0,0,1,1698,Y
Lichfield 011A,E01029513,0,0,0,1693,Y,1,1,0,0,0,0,0,2,1695,Y
Lichfield 011B,E01029514,0,0,0,1693,Y,1,0,0,0,0,0,0,1,1698,Y
North Warwickshire 004A,E01031023,1,0,1,1685,Y,2,1,1,1,1,0,0,6,1682,Y
North Warwickshire 007C,E01031027,0,0,0,1693,Y,1,0,0,0,0,0,0,1,1698,Y
North Warwickshire 007D,E01031028,3,0,3,1651,Y,4,7,0,0,2,1,0,14,1634,Y
Nuneaton and Bedworth 015E,E01031099,0,0,0,1693,Y,1,2,0,0,1,0,0,4,1687,Y
Nuneaton and Bedworth 018A,E01031077,2,0,2,1666,Y,2,1,0,1,0,0,0,4,1687,Y
Nuneaton and Bedworth 018B,E01031078,2,0,2,1666,Y,0,0,1,1,2,0,0,4,1687,Y
Nuneaton and Bedworth 018D,E01031080,0,0,0,1693,Y,0,2,0,0,0,0,0,2,1695,Y
Nuneaton and Bedworth 018E,E01032588,7,0,7,1518,Y,0,1,0,1,0,0,0,2,1695,Y
Rugby 001C,E01031159,2,1,3,1651,Y,2,3,0,0,1,0,0,6,1682,Y
Sandwell 001A,E01010085,37,6,43,361,Y,20,21,1,21,14,28,3,108,187,Y
Sandwell 001B,E01010086,30,0,30,686,Y,9,18,0,13,5,0,0,45,929,Y
Sandwell 001C,E01010087,15,0,15,1217,Y,26,43,2,14,10,85,1,181,75,N
Sandwell 001D,E01010088,14,0,14,1251,Y,11,10,0,6,0,0,1,28,1373,Y
Sandwell 001E,E01010089,24,3,27,781,Y,21,27,2,16,2,2,0,70,445,Y
Sandwell 002A,E01009969,28,1,29,716,Y,9,15,0,14,4,1,1,44,958,Y
Sandwell 002B,E01009970,9,2,11,1355,Y,11,16,0,8,6,0,1,42,1014,Y
Sandwell 002C,E01009971,25,4,29,716,Y,14,20,0,18,7,0,0,59,618,Y
Sandwell 002D,E01009973,15,8,23,927,Y,6,14,1,10,2,0,1,34,1219,Y
Sandwell 003A,E01009960,21,1,22,965,Y,9,20,3,9,4,7,0,52,757,Y
Sandwell 003B,E01009961,13,3,16,1171,Y,4,12,0,4,3,1,0,24,1462,Y
Sandwell 003C,E01009966,21,8,29,716,Y,6,8,2,13,4,0,1,34,1219,Y
Sandwell 003D,E01009967,27,0,27,781,Y,8,17,0,8,4,0,0,37,1139,Y
Sandwell 003E,E01010092,22,4,26,817,Y,13,8,1,7,22,3,0,54,704,Y
Sandwell 004A,E01009962,16,1,17,1137,Y,3,4,0,6,3,0,0,16,1608,Y
Sandwell 004B,E01009963,29,1,30,686,Y,19,8,2,15,7,12,1,64,521,Y
Sandwell 004C,E01009964,23,4,27,781,Y,11,12,3,8,5,0,0,39,1104,Y
Sandwell 004D,E01009965,21,0,21,989,Y,3,7,0,7,6,0,0,23,1483,Y
Sandwell 005A,E01010090,39,4,43,361,Y,50,49,0,45,49,12,6,211,59,Y
Sandwell 005B,E01010091,16,1,17,1137,Y,10,19,0,13,16,1,0,59,618,Y
Sandwell 005C,E01010096,52,6,58,179,Y,24,24,2,24,17,39,8,138,122,N
Sandwell 005D,E01010097,16,0,16,1171,Y,10,32,0,11,3,0,0,56,668,Y
Sandwell 006A,E01009968,12,2,14,1251,Y,7,5,0,5,1,0,0,18,1572,Y
Sandwell 006B,E01009972,15,1,16,1171,Y,10,22,0,5,21,2,1,61,573,Y
Sandwell 006C,E01009974,16,14,30,686,Y,15,20,1,13,13,4,0,66,490,Y
Sandwell 006D,E01009975,13,0,13,1288,Y,10,5,0,2,2,0,0,19,1563,Y
Sandwell 007A,E01010030,46,13,59,169,Y,21,28,1,19,8,9,0,86,294,Y
Sandwell 007B,E01010034,11,0,11,1355,Y,5,11,0,6,3,0,0,25,1442,Y
Sandwell 007C,E01010035,27,4,31,655,Y,15,29,0,15,7,0,0,66,490,Y
Sandwell 007D,E01010036,18,2,20,1025,Y,10,19,1,9,5,0,0,44,958,Y
Sandwell 009A,E01009982,22,1,23,927,Y,10,11,1,12,4,0,0,38,1115,Y
Sandwell 009B,E01009983,26,6,32,621,Y,6,14,2,16,2,0,1,41,1044,Y
Sandwell 009C,E01010029,28,1,29,716,Y,7,16,0,10,3,0,0,36,1162,Y
Sandwell 009D,E01010037,27,1,28,751,Y,8,11,1,12,9,0,0,41,1044,Y
Sandwell 010A,E01009991,29,1,30,686,Y,18,10,0,17,4,0,0,49,830,Y
Sandwell 010B,E01009994,39,1,40,425,Y,16,17,1,14,8,10,1,67,476,Y
Sandwell 010C,E01009995,23,0,23,927,Y,14,12,1,9,8,1,0,45,929,Y
Sandwell 010D,E01009996,24,1,25,848,Y,9,14,2,11,5,0,0,41,1044,Y
Sandwell 010E,E01009997,43,0,43,361,Y,6,17,1,11,8,0,0,43,992,Y
Sandwell 010F,E01009998,43,3,46,311,Y,37,22,3,26,7,5,0,100,211,Y
Sandwell 011A,E01010008,24,3,27,781,Y,10,6,1,4,1,1,0,23,1483,Y
Sandwell 011B,E01010010,31,5,36,529,Y,11,8,1,12,9,15,4,60,594,Y
Sandwell 011C,E01010011,7,7,14,1251,Y,32,17,0,5,3,6,2,65,504,Y
Sandwell 011D,E01010012,8,0,8,1484,Y,6,6,0,3,4,0,0,19,1563,Y
Sandwell 012A,E01010007,23,3,26,817,Y,13,8,0,7,1,0,0,29,1346,Y
Sandwell 012B,E01010009,13,2,15,1217,Y,2,10,0,6,5,0,0,23,1483,Y
Sandwell 012C,E01010013,8,2,10,1405,Y,19,4,0,6,2,2,0,33,1242,Y
Sandwell 012D,E01010014,17,5,22,965,Y,23,7,0,11,4,0,0,45,929,Y
Sandwell 013A,E01010093,29,0,29,716,Y,10,35,3,25,2,0,1,76,387,Y
Sandwell 013B,E01010094,17,3,20,1025,Y,12,13,0,3,6,12,0,46,903,Y
Sandwell 013C,E01010095,42,1,43,361,Y,23,29,2,34,16,3,0,107,191,N
Sandwell 013D,E01010098,31,5,36,529,Y,20,16,2,27,2,0,2,69,456,Y
Sandwell 013E,E01010099,17,1,18,1103,Y,18,18,0,7,3,1,1,48,858,Y
Sandwell 013F,E01010100,26,4,30,686,Y,29,30,0,17,16,2,1,95,246,Y
Sandwell 014A,E01009978,21,7,28,751,Y,5,10,0,15,6,41,0,77,371,Y
Sandwell 014B,E01010031,33,6,39,449,Y,14,17,2,21,6,14,3,77,371,Y
Sandwell 014C,E01010032,43,1,44,343,Y,10,16,3,14,12,0,0,55,681,Y
Sandwell 014D,E01010033,42,3,45,328,Y,16,28,1,24,9,2,1,81,340,Y
Sandwell 014E,E01010074,62,8,70,104,Y,34,58,4,46,40,2,1,185,70,N
Sandwell 015A,E01010066,26,3,29,716,Y,10,18,4,16,8,0,0,56,668,Y
Sandwell 015B,E01010067,32,3,35,554,Y,5,9,1,10,4,0,1,30,1319,Y
Sandwell 015C,E01010068,16,0,16,1171,Y,16,31,4,20,7,0,0,78,356,Y
Sandwell 015D,E01010070,24,3,27,781,Y,15,21,3,10,5,2,1,57,656,Y
Sandwell 015E,E01010075,13,1,14,1251,Y,12,15,1,6,6,0,0,40,1076,Y
Sandwell 015F,E01010076,27,6,33,596,Y,27,29,0,21,9,10,3,99,224,Y
Sandwell 016A,E01009976,46,1,47,291,Y,19,29,5,12,14,8,1,88,277,Y
Sandwell 016B,E01009977,35,3,38,475,Y,13,18,2,15,34,13,2,97,238,Y
Sandwell 016C,E01009979,50,2,52,232,Y,15,16,1,40,8,9,3,92,257,Y
Sandwell 016D,E01009980,36,7,43,361,Y,9,24,3,19,14,7,2,78,356,Y
Sandwell 016E,E01010069,28,0,28,751,Y,11,12,0,7,3,22,0,55,681,Y
Sandwell 016F,E01010071,38,5,43,361,Y,21,36,9,16,27,27,1,137,123,N
Sandwell 017A,E01009947,45,6,51,248,Y,13,20,1,35,11,6,2,88,277,Y
Sandwell 017B,E01009992,30,2,32,621,Y,3,21,1,14,4,0,1,44,958,Y
Sandwell 017C,E01009993,73,4,77,75,Y,10,14,1,26,11,0,1,63,538,Y
Sandwell 017D,E01010103,76,9,85,56,Y,16,25,3,49,28,6,5,132,134,Y
Sandwell 017E,E01010104,32,8,40,425,Y,18,10,0,18,4,0,1,51,782,Y
Sandwell 017F,E01010105,34,13,47,291,Y,17,32,2,12,12,0,2,77,371,Y
Sandwell 018A,E01009981,52,15,67,116,Y,36,35,5,32,55,72,4,239,45,N
Sandwell 018C,E01009985,22,3,25,848,Y,6,6,1,6,4,0,0,23,1483,Y
Sandwell 018E,E01032887,69,6,75,88,Y,25,17,4,31,18,0,1,96,243,Y
Sandwell 019A,E01009986,20,1,21,989,Y,6,1,2,11,2,0,0,22,1509,Y
Sandwell 019B,E01009987,35,2,37,496,Y,7,9,2,21,1,0,1,41,1044,Y
Sandwell 019C,E01009989,34,2,36,529,Y,16,20,1,14,9,0,2,62,554,Y
Sandwell 019D,E01010106,94,16,110,23,Y,29,18,14,38,58,155,11,323,27,N
Sandwell 020A,E01009988,60,5,65,135,Y,13,24,5,21,16,25,1,105,197,Y
Sandwell 020B,E01010101,30,3,33,596,Y,9,37,2,21,14,0,0,83,320,Y
Sandwell 020C,E01010102,81,16,97,35,Y,26,19,5,32,29,110,9,230,50,N
Sandwell 020D,E01010107,74,12,86,52,Y,22,20,4,24,40,178,21,309,29,N
Sandwell 021A,E01010015,21,4,25,848,Y,32,31,1,11,40,3,0,118,167,Y
Sandwell 021B,E01010016,32,1,33,596,Y,10,10,0,8,2,0,1,31,1290,Y
Sandwell 021C,E01010018,55,3,58,179,Y,16,56,1,23,38,45,0,179,76,N
Sandwell 021D,E01010072,40,4,44,343,Y,12,18,2,11,15,7,1,66,490,Y
Sandwell 021E,E01010073,12,1,13,1288,Y,5,8,0,8,4,0,0,25,1442,Y
Sandwell 022A,E01010077,32,2,34,584,Y,6,10,1,24,3,1,2,47,883,Y
Sandwell 022B,E01010079,13,0,13,1288,Y,5,8,1,7,1,0,0,22,1509,Y
Sandwell 022C,E01010080,50,6,56,191,Y,12,41,1,19,10,0,0,83,320,Y
Sandwell 022D,E01010081,16,1,17,1137,Y,4,13,0,3,4,0,0,24,1462,Y
Sandwell 022E,E01010082,23,1,24,885,Y,13,21,1,10,9,0,3,57,656,Y
Sandwell 022F,E01010083,38,1,39,449,Y,10,15,0,8,10,0,0,43,992,Y
Sandwell 022G,E01010084,34,1,35,554,Y,7,8,0,19,2,0,1,37,1139,Y
Sandwell 023A,E01010046,55,10,65,135,Y,18,33,0,16,8,0,1,76,387,Y
Sandwell 023B,E01010047,58,7,65,135,Y,25,25,5,25,15,3,2,100,211,Y
Sandwell 023C,E01010048,22,3,25,848,Y,1,6,0,6,4,0,0,17,1593,Y
Sandwell 023D,E01010049,40,15,55,202,Y,10,17,2,10,10,2,3,54,704,Y
Sandwell 023E,E01010050,24,3,27,781,Y,12,10,0,7,3,0,0,32,1265,Y
Sandwell 023F,E01010052,35,6,41,405,Y,12,13,0,11,70,14,0,120,162,Y
Sandwell 023G,E01010053,38,5,43,361,Y,33,22,4,21,7,1,2,90,269,Y
Sandwell 024A,E01010017,70,1,71,99,Y,37,45,9,36,143,59,4,333,26,N
Sandwell 024B,E01010019,36,3,39,449,Y,32,23,0,18,9,0,1,83,320,Y
Sandwell 024C,E01010020,15,4,19,1059,Y,25,14,0,10,4,0,0,53,731,Y
Sandwell 024D,E01010021,12,1,13,1288,Y,12,19,0,16,5,0,0,52,757,Y
Sandwell 025A,E01010039,38,1,39,449,Y,8,8,2,11,4,0,0,33,1242,Y
Sandwell 025B,E01010043,13,3,16,1171,Y,6,5,0,13,2,0,0,26,1420,Y
Sandwell 025C,E01010044,26,1,27,781,Y,7,17,0,20,4,1,0,49,830,Y
Sandwell 025D,E01010078,9,1,10,1405,Y,9,10,0,11,6,9,1,46,903,Y
Sandwell 026A,E01010059,32,6,38,475,Y,9,4,1,19,11,21,2,67,476,Y
Sandwell 026B,E01010061,61,16,77,75,Y,12,21,3,32,16,159,11,254,39,Y
Sandwell 026C,E01010062,41,6,47,291,Y,31,25,1,21,20,0,1,99,224,Y
Sandwell 026D,E01010063,66,9,75,88,Y,31,45,1,45,16,2,2,142,118,N
Sandwell 026E,E01010064,68,18,86,52,Y,11,14,0,20,10,4,6,65,504,Y
Sandwell 026F,E01010065,44,4,48,276,Y,9,18,1,26,8,0,0,62,554,Y
Sandwell 027A,E01009934,61,6,67,116,Y,13,14,3,22,8,8,2,70,445,Y
Sandwell 027B,E01009935,30,2,32,621,Y,20,17,0,12,8,0,0,57,656,Y
Sandwell 027C,E01009936,27,2,29,716,Y,8,12,1,13,2,8,0,44,958,Y
Sandwell 027D,E01010004,41,3,44,343,Y,8,26,0,15,12,23,0,84,314,Y
Sandwell 028A,E01010054,65,15,80,65,Y,14,21,2,28,20,1,2,88,277,Y
Sandwell 028B,E01010055,21,3,24,885,Y,9,10,1,8,4,0,2,34,1219,Y
Sandwell 028C,E01010056,15,4,19,1059,Y,12,11,0,10,2,13,0,48,858,Y
Sandwell 028D,E01010057,9,1,10,1405,Y,7,5,1,8,2,0,0,23,1483,Y
Sandwell 028E,E01010060,41,5,46,311,Y,17,13,1,21,5,1,2,60,594,Y
Sandwell 029A,E01010038,19,4,23,927,Y,15,21,0,18,8,2,0,64,521,Y
Sandwell 029B,E01010040,16,2,18,1103,Y,8,18,1,14,7,0,0,48,858,Y
Sandwell 029C,E01010041,18,0,18,1103,Y,6,15,0,18,4,3,0,46,903,Y
Sandwell 029D,E01010045,25,1,26,817,Y,10,7,1,11,2,0,0,31,1290,Y
Sandwell 030A,E01010000,15,5,20,1025,Y,5,17,2,9,4,0,2,39,1104,Y
Sandwell 030B,E01010002,28,3,31,655,Y,17,32,3,10,23,59,2,146,114,Y
Sandwell 030C,E01010003,25,1,26,817,Y,9,10,1,13,5,2,2,42,1014,Y
Sandwell 030D,E01010005,23,3,26,817,Y,18,19,1,14,9,0,1,62,554,Y
Sandwell 030E,E01010006,20,4,24,885,Y,13,26,2,9,22,0,0,72,427,Y
Sandwell 031A,E01009938,24,3,27,781,Y,24,14,2,9,2,0,1,52,757,Y
Sandwell 031B,E01009943,25,6,31,655,Y,8,10,1,13,1,0,1,34,1219,Y
Sandwell 031C,E01009944,37,2,39,449,Y,14,10,3,14,9,4,0,54,704,Y
Sandwell 031D,E01010051,14,2,16,1171,Y,11,8,0,10,0,0,0,29,1346,Y
Sandwell 031E,E01010058,25,1,26,817,Y,14,13,2,8,3,0,0,40,1076,Y
Sandwell 032A,E01009937,18,2,20,1025,Y,8,13,3,7,7,0,0,38,1115,Y
Sandwell 032B,E01009939,22,1,23,927,Y,13,22,2,11,2,0,1,51,782,Y
Sandwell 032C,E01009940,17,1,18,1103,Y,9,10,0,7,2,4,0,32,1265,Y
Sandwell 032D,E01009941,13,4,17,1137,Y,27,7,0,7,3,1,0,45,929,Y
Sandwell 032E,E01009942,27,2,29,716,Y,15,17,1,12,2,4,0,51,782,Y
Sandwell 033A,E01009929,27,3,30,686,Y,12,12,0,21,4,0,0,49,830,Y
Sandwell 033B,E01009930,16,0,16,1171,Y,10,9,0,10,2,1,0,32,1265,Y
Sandwell 033C,E01009931,25,3,28,751,Y,15,32,0,11,5,0,0,63,538,Y
Sandwell 033D,E01009932,61,9,70,104,Y,19,14,3,17,20,74,8,155,102,Y
Sandwell 033E,E01009999,29,5,34,584,Y,15,19,0,23,12,24,2,95,246,Y
Sandwell 034A,E01009921,28,2,30,686,Y,11,11,2,8,9,14,1,56,668,Y
Sandwell 034B,E01009922,5,0,5,1592,Y,11,8,1,3,3,0,0,26,1420,Y
Sandwell 034C,E01009924,11,0,11,1355,Y,26,26,0,4,3,0,1,60,594,Y
Sandwell 034D,E01009925,6,1,7,1518,Y,11,15,0,4,1,0,0,31,1290,Y
Sandwell 034E,E01009926,8,1,9,1445,Y,14,14,2,3,4,4,1,42,1014,Y
Sandwell 034F,E01009927,58,13,71,99,Y,19,28,4,15,37,155,9,267,37,N
Sandwell 034G,E01009928,34,3,37,496,Y,7,7,1,9,5,0,1,30,1319,Y
Sandwell 035A,E01009933,13,0,13,1288,Y,7,3,0,11,0,0,0,21,1531,Y
Sandwell 035B,E01009952,61,4,65,135,Y,5,20,0,26,9,0,0,60,594,Y
Sandwell 035C,E01009955,42,1,43,361,Y,15,26,7,45,29,38,5,165,89,Y
Sandwell 035D,E01009956,40,3,43,361,Y,13,20,1,12,11,1,1,59,618,Y
Sandwell 035E,E01009959,7,0,7,1518,Y,6,11,0,2,0,0,1,20,1545,Y
Sandwell 035F,E01010042,24,2,26,817,Y,7,12,2,15,13,1,0,50,805,Y
Sandwell 036A,E01009923,13,9,22,965,Y,24,15,0,5,5,1,0,50,805,Y
Sandwell 036B,E01010024,11,4,15,1217,Y,11,17,0,4,2,4,0,38,1115,Y
Sandwell 036C,E01010026,15,1,16,1171,Y,22,18,0,18,7,0,1,66,490,Y
Sandwell 036D,E01010027,19,2,21,989,Y,24,21,0,10,11,0,0,66,490,Y
Sandwell 037A,E01010001,15,1,16,1171,Y,10,19,1,7,6,0,0,43,992,Y
Sandwell 037B,E01010022,7,0,7,1518,Y,10,5,0,3,0,0,0,18,1572,Y
Sandwell 037C,E01010023,14,8,22,965,Y,25,22,2,5,4,26,2,86,294,Y
Sandwell 037D,E01010025,25,1,26,817,Y,33,9,0,13,6,0,0,61,573,Y
Sandwell 037E,E01010028,18,5,23,927,Y,8,13,0,15,2,10,0,48,858,Y
Sandwell 038A,E01009953,39,0,39,449,Y,27,33,3,25,16,13,3,120,162,Y
Sandwell 038B,E01009954,19,2,21,989,Y,11,13,1,4,18,1,0,48,858,Y
Sandwell 038C,E01009957,25,2,27,781,Y,8,6,0,18,3,0,1,36,1162,Y
Sandwell 038D,E01009958,6,2,8,1484,Y,23,14,0,2,6,0,0,45,929,Y
Sandwell 039A,E01009946,22,5,27,781,Y,8,15,0,5,3,0,0,31,1290,Y
Sandwell 039B,E01009948,8,1,9,1445,Y,7,6,0,2,2,0,0,17,1593,Y
Sandwell 039C,E01009949,6,3,9,1445,Y,12,16,0,6,6,0,0,40,1076,Y
Sandwell 039D,E01009950,24,7,31,655,Y,16,18,1,22,7,1,2,67,476,Y
Sandwell 039E,E01009951,43,7,50,257,Y,17,20,0,27,5,0,0,69,456,Y
Sandwell 039F,E01032592,23,1,24,885,Y,17,25,0,16,10,35,0,103,201,N
Solihull 001A,E01010118,10,1,11,1355,Y,7,9,5,8,2,0,1,32,1265,Y
Solihull 001B,E01010120,24,3,27,781,Y,14,8,1,17,2,0,0,42,1014,Y
Solihull 001C,E01010121,11,2,13,1288,Y,17,20,3,10,10,0,0,60,594,Y
Solihull 001D,E01010122,10,2,12,1319,Y,10,18,0,21,30,0,0,79,349,Y
Solihull 002A,E01010235,38,2,40,425,Y,5,8,1,30,1,0,1,46,903,Y
Solihull 002B,E01010236,26,0,26,817,Y,3,6,0,19,1,0,0,29,1346,Y
Solihull 002C,E01010239,16,1,17,1137,Y,6,11,0,15,3,0,0,35,1190,Y
Solihull 002D,E01010240,28,4,32,621,Y,10,8,3,15,4,8,0,48,858,Y
Solihull 003A,E01010117,11,2,13,1288,Y,12,12,1,9,3,1,0,38,1115,Y
Solihull 003B,E01010119,10,3,13,1288,Y,9,7,0,10,5,20,1,52,757,Y
Solihull 003C,E01010123,25,3,28,751,Y,10,24,1,12,44,40,4,135,126,Y
Solihull 003D,E01010124,16,1,17,1137,Y,9,12,0,10,20,28,0,79,349,Y
Solihull 004A,E01010146,33,3,36,529,Y,15,14,4,20,10,9,0,72,427,Y
Solihull 004B,E01010234,56,10,66,123,Y,7,7,3,36,14,3,1,71,436,Y
Solihull 004C,E01010237,34,3,37,496,Y,9,10,1,17,6,0,1,44,958,Y
Solihull 004D,E01010238,23,2,25,848,Y,4,7,1,12,2,0,1,27,1397,Y
Solihull 005A,E01010145,38,7,45,328,Y,17,22,1,32,62,15,2,151,106,Y
Solihull 005B,E01010147,35,2,37,496,Y,9,12,0,25,3,0,0,49,830,Y
Solihull 005C,E01010148,33,1,34,584,Y,13,5,2,17,7,0,0,44,958,Y
Solihull 005D,E01010149,24,2,26,817,Y,18,14,3,13,2,0,1,51,782,Y
Solihull 006A,E01010125,80,10,90,47,Y,18,13,5,49,33,278,9,405,14,N
Solihull 006B,E01010129,59,7,66,123,Y,10,11,1,23,3,1,3,52,757,Y
Solihull 006C,E01010139,48,2,50,257,Y,4,14,3,20,6,0,0,47,883,Y
Solihull 006D,E01010141,31,2,33,596,Y,7,11,1,7,4,0,0,30,1319,Y
Solihull 007A,E01010140,35,2,37,496,Y,14,6,1,19,7,0,1,48,858,Y
Solihull 007B,E01010142,46,6,52,232,Y,15,9,0,32,17,9,0,82,330,Y
Solihull 007C,E01010143,44,4,48,276,Y,8,14,0,35,4,0,2,63,538,Y
Solihull 007D,E01010144,28,3,31,655,Y,13,10,0,21,4,0,1,49,830,Y
Solihull 008A,E01010111,64,2,66,123,Y,26,14,3,28,4,0,0,75,400,Y
Solihull 008B,E01010126,36,2,38,475,Y,19,4,1,14,5,1,0,44,958,Y
Solihull 008C,E01010127,30,3,33,596,Y,13,11,0,24,13,1,0,62,554,Y
Solihull 008D,E01010128,31,0,31,655,Y,15,11,0,13,4,0,0,43,992,Y
Solihull 008E,E01010130,41,5,46,311,Y,15,12,5,29,14,0,1,76,387,Y
Solihull 008F,E01010131,35,6,41,405,Y,15,8,1,14,9,1,1,49,830,Y
Solihull 009A,E01010109,88,6,94,38,Y,28,188,3,54,270,59,20,622,9,N
Solihull 009B,E01010110,65,2,67,116,Y,18,21,0,19,5,0,0,63,538,Y
Solihull 009C,E01010112,25,1,26,817,Y,8,9,2,7,2,0,0,28,1373,Y
Solihull 009D,E01010113,11,1,12,1319,Y,11,15,1,15,3,0,0,45,929,Y
Solihull 009E,E01010114,19,2,21,989,Y,31,16,3,14,13,13,1,91,263,Y
Solihull 010A,E01010157,9,1,10,1405,Y,9,21,0,9,1,0,0,40,1076,Y
Solihull 010B,E01010159,9,2,11,1355,Y,12,13,0,17,0,0,0,42,1014,Y
Solihull 010C,E01010162,2,1,3,1651,Y,8,15,0,6,2,0,0,31,1290,Y
Solihull 010D,E01010163,10,3,13,1288,Y,6,7,0,11,1,0,1,26,1420,Y
Solihull 011A,E01010132,6,2,8,1484,Y,5,11,1,10,3,5,0,35,1190,Y
Solihull 011B,E01010133,19,0,19,1059,Y,11,7,2,11,16,9,1,57,656,Y
Solihull 011C,E01010134,9,1,10,1405,Y,8,7,1,3,1,1,0,21,1531,Y
Solihull 011D,E01010135,14,1,15,1217,Y,16,15,3,11,2,0,0,47,883,Y
Solihull 011E,E01010138,17,6,23,927,Y,17,17,1,10,8,0,0,53,731,Y
Solihull 012A,E01010136,1,0,1,1685,Y,2,14,0,2,1,0,0,19,1563,Y
Solihull 012B,E01010137,27,2,29,716,Y,3,15,2,13,9,0,0,42,1014,Y
Solihull 012C,E01010158,30,4,34,584,Y,7,36,4,24,9,17,0,97,238,Y
Solihull 012D,E01010160,22,5,27,781,Y,17,15,3,15,5,12,0,67,476,Y
Solihull 012E,E01010161,6,1,7,1518,Y,13,16,0,13,2,0,0,44,958,Y
Solihull 013A,E01010174,17,2,19,1059,Y,19,25,1,26,9,0,0,80,344,Y
Solihull 013B,E01010175,21,0,21,989,Y,23,31,1,15,9,0,2,81,340,Y
Solihull 013C,E01010177,9,1,10,1405,Y,15,10,0,10,0,0,0,35,1190,Y
Solihull 013D,E01010178,35,3,38,475,Y,20,24,11,11,71,28,1,166,87,Y
Solihull 014A,E01010172,8,0,8,1484,Y,16,18,0,2,2,0,0,38,1115,Y
Solihull 014B,E01010173,4,0,4,1626,Y,8,12,2,4,0,0,0,26,1420,Y
Solihull 014C,E01010176,6,0,6,1556,Y,9,18,1,3,4,0,0,35,1190,Y
Solihull 014D,E01010179,2,2,4,1626,Y,6,21,0,7,9,1,1,45,929,Y
Solihull 015A,E01010115,18,1,19,1059,Y,24,11,0,9,14,0,0,58,635,Y
Solihull 015B,E01010116,4,0,4,1626,Y,3,6,0,14,1,0,0,24,1462,Y
Solihull 015C,E01010227,12,0,12,1319,Y,30,15,1,6,2,0,0,54,704,Y
Solihull 015D,E01010228,10,1,11,1355,Y,11,17,2,11,2,0,0,43,992,Y
Solihull 015E,E01010232,18,1,19,1059,Y,12,12,1,17,6,0,0,48,858,Y
Solihull 016A,E01010195,8,0,8,1484,Y,10,12,0,1,2,0,0,25,1442,Y
Solihull 016B,E01010226,29,1,30,686,Y,14,9,5,13,17,0,0,58,635,Y
Solihull 016C,E01010229,7,0,7,1518,Y,11,22,0,6,19,17,0,75,400,Y
Solihull 016D,E01010230,15,0,15,1217,Y,11,9,1,8,6,2,0,37,1139,Y
Solihull 016E,E01010231,5,1,6,1556,Y,9,8,0,1,0,0,0,18,1572,Y
Solihull 016F,E01010233,21,3,24,885,Y,19,11,0,15,5,14,0,64,521,Y
Solihull 017A,E01010108,14,0,14,1251,Y,32,28,1,10,5,0,2,78,356,Y
Solihull 017B,E01010164,7,1,8,1484,Y,13,19,1,13,2,0,0,48,858,Y
Solihull 017C,E01010165,15,2,17,1137,Y,6,34,0,9,10,2,1,62,554,Y
Solihull 017D,E01010167,12,0,12,1319,Y,15,6,1,3,2,0,0,27,1397,Y
Solihull 018A,E01010199,12,0,12,1319,Y,6,13,0,4,4,0,0,27,1397,Y
Solihull 018B,E01010200,12,1,13,1288,Y,13,14,0,5,3,4,0,39,1104,Y
Solihull 018C,E01010201,9,1,10,1405,Y,19,10,0,4,6,14,0,53,731,Y
Solihull 018D,E01010204,29,4,33,596,Y,15,20,5,24,10,9,3,86,294,Y
Solihull 018E,E01010205,5,1,6,1556,Y,13,16,0,4,1,2,0,36,1162,Y
Solihull 018F,E01010206,9,0,9,1445,Y,9,17,4,8,9,3,1,51,782,Y
Solihull 019A,E01010192,131,28,159,16,N,24,16,34,40,72,194,37,417,13,N
Solihull 019B,E01010196,10,0,10,1405,Y,17,14,0,4,3,0,0,38,1115,Y
Solihull 019C,E01010197,6,1,7,1518,Y,8,14,0,6,1,0,0,29,1346,Y
Solihull 019D,E01010198,82,5,87,51,N,22,9,8,33,39,51,9,171,81,Y
Solihull 021A,E01010218,21,2,23,927,Y,9,22,1,10,9,2,1,54,704,Y
Solihull 021B,E01010219,15,6,21,989,Y,8,19,0,2,1,0,0,30,1319,Y
Solihull 021C,E01010221,7,2,9,1445,Y,13,21,0,4,3,0,0,41,1044,Y
Solihull 021D,E01010222,4,1,5,1592,Y,6,11,0,5,14,1,0,37,1139,Y
Solihull 022A,E01010191,12,3,15,1217,Y,8,18,2,6,2,0,2,38,1115,Y
Solihull 022B,E01010202,2,0,2,1666,Y,3,11,1,2,0,0,0,17,1593,Y
Solihull 022C,E01010203,11,0,11,1355,Y,10,16,4,7,81,110,0,228,51,N
Solihull 022D,E01010209,14,0,14,1251,Y,26,24,4,14,5,61,2,136,124,Y
Solihull 022E,E01010213,19,3,22,965,Y,20,26,1,12,32,17,1,109,186,N
Solihull 023A,E01010208,5,0,5,1592,Y,5,14,1,3,26,3,0,52,757,Y
Solihull 023B,E01010210,3,1,4,1626,Y,3,13,0,2,3,0,0,21,1531,Y
Solihull 023C,E01010211,16,1,17,1137,Y,10,17,4,8,4,0,0,43,992,Y
Solihull 023D,E01010217,9,0,9,1445,Y,13,19,0,4,4,20,0,60,594,Y
Solihull 024A,E01010190,1,1,2,1666,Y,3,1,0,2,0,0,0,6,1682,Y
Solihull 024B,E01010193,2,2,4,1626,Y,4,8,1,1,0,0,0,14,1634,Y
Solihull 024C,E01010194,2,0,2,1666,Y,5,6,0,3,0,0,0,14,1634,Y
Solihull 024D,E01010207,9,1,10,1405,Y,6,15,0,1,5,9,0,36,1162,Y
Solihull 025A,E01010166,6,0,6,1556,Y,20,5,1,4,5,0,0,35,1190,Y
Solihull 025B,E01010168,15,1,16,1171,Y,15,29,1,17,46,26,1,135,126,Y
Solihull 025C,E01010169,12,0,12,1319,Y,7,15,0,10,29,25,0,86,294,Y
Solihull 025D,E01010170,3,0,3,1651,Y,3,8,0,3,3,0,0,17,1593,Y
Solihull 025E,E01010171,6,0,6,1556,Y,5,13,0,6,2,0,0,26,1420,Y
Solihull 026A,E01010151,13,3,16,1171,Y,23,32,0,12,7,11,3,88,277,Y
Solihull 026B,E01010152,1,0,1,1685,Y,12,9,2,0,2,0,0,25,1442,Y
Solihull 026C,E01010153,6,0,6,1556,Y,8,8,0,4,15,3,0,38,1115,Y
Solihull 026D,E01010154,16,5,21,989,Y,12,12,0,4,2,0,0,30,1319,Y
Solihull 026E,E01010155,7,0,7,1518,Y,9,6,0,4,2,1,0,22,1509,Y
Solihull 026F,E01010156,3,0,3,1651,Y,7,17,0,5,0,0,0,29,1346,Y
Solihull 027A,E01010212,3,2,5,1592,Y,5,14,0,4,4,0,0,27,1397,Y
Solihull 027B,E01010214,5,1,6,1556,Y,3,3,0,1,2,0,0,9,1671,Y
Solihull 027C,E01010215,16,0,16,1171,Y,8,23,0,6,6,0,0,43,992,Y
Solihull 027D,E01010216,10,0,10,1405,Y,5,17,2,5,32,8,0,69,456,Y
Solihull 028A,E01010150,0,0,0,1693,Y,7,3,0,5,0,0,0,15,1627,Y
Solihull 028B,E01010184,9,0,9,1445,Y,8,35,1,5,2,7,0,58,635,Y
Solihull 028C,E01010185,2,0,2,1666,Y,10,3,0,0,1,0,0,14,1634,Y
Solihull 028D,E01010186,6,0,6,1556,Y,7,13,0,3,1,0,0,24,1462,Y
Solihull 028E,E01010187,5,0,5,1592,Y,17,21,0,2,25,0,0,65,504,Y
Solihull 028F,E01010188,16,1,17,1137,Y,9,8,3,6,11,24,0,61,573,Y
Solihull 029A,E01010180,7,2,9,1445,Y,5,11,1,11,1,0,0,29,1346,Y
Solihull 029B,E01010181,15,1,16,1171,Y,18,33,1,7,2,0,0,61,573,Y
Solihull 029D,E01010183,12,1,13,1288,Y,5,19,1,10,9,6,1,51,782,Y
Solihull 029E,E01010189,12,0,12,1319,Y,25,28,0,6,2,2,0,63,538,Y
Solihull 029F,E01032885,7,0,7,1518,Y,6,11,3,4,3,7,0,34,1219,Y
Solihull 029G,E01032886,17,1,18,1103,Y,18,21,5,15,11,2,0,72,427,Y
Solihull 030A,E01010220,8,1,9,1445,Y,15,16,0,5,3,0,2,41,1044,Y
Solihull 030B,E01010223,15,0,15,1217,Y,16,13,3,9,5,3,1,50,805,Y
Solihull 030C,E01010225,4,0,4,1626,Y,3,6,0,4,3,0,0,16,1608,Y
Solihull 030D,E01032590,30,3,33,596,Y,25,27,16,21,36,84,2,211,59,Y
South Staffordshire 006A,E01029616,0,0,0,1693,Y,0,0,0,0,1,0,0,1,1698,Y
South Staffordshire 007A,E01029632,2,0,2,1666,Y,2,1,0,0,1,0,0,4,1687,Y
South Staffordshire 009E,E01029631,0,0,0,1693,Y,0,0,0,0,1,0,0,1,1698,Y
South Staffordshire 010B,E01029661,0,0,0,1693,Y,0,0,0,0,1,0,0,1,1698,Y
South Staffordshire 012B,E01029673,0,0,0,1693,Y,0,0,0,0,2,4,0,6,1682,Y
South Staffordshire 013A,E01029645,0,0,0,1693,Y,0,1,0,0,0,0,0,1,1698,Y
South Staffordshire 013C,E01029672,1,0,1,1685,Y,0,0,0,0,0,0,0,0,1708,Y
South Staffordshire 014D,E01029652,0,0,0,1693,Y,0,0,0,0,0,0,0,0,1708,Y
Stratford-on-Avon 001B,E01031243,0,0,0,1693,Y,0,1,0,0,0,0,0,1,1698,Y
Walsall 001A,E01010301,15,0,15,1217,Y,6,5,1,17,5,3,0,37,1139,Y
Walsall 001B,E01010303,23,2,25,848,Y,9,10,1,4,3,4,0,31,1290,Y
Walsall 001C,E01010306,30,5,35,554,Y,24,13,2,14,18,57,6,134,129,Y
Walsall 001D,E01010307,9,1,10,1405,Y,16,15,0,8,3,0,0,42,1014,Y
Walsall 002A,E01010302,27,0,27,781,Y,8,8,3,7,6,1,1,34,1219,Y
Walsall 002B,E01010304,10,0,10,1405,Y,2,7,1,3,3,0,0,16,1608,Y
Walsall 002C,E01010305,24,0,24,885,Y,6,4,0,5,3,0,0,18,1572,Y
Walsall 002D,E01010308,44,0,44,343,Y,9,9,4,12,16,8,3,61,573,Y
Walsall 003A,E01010345,9,0,9,1445,Y,10,12,0,6,5,0,0,33,1242,Y
Walsall 003B,E01010346,5,1,6,1556,Y,13,10,0,4,0,0,0,27,1397,Y
Walsall 003C,E01010347,21,1,22,965,Y,7,8,1,14,2,0,0,32,1265,Y
Walsall 003D,E01010350,4,0,4,1626,Y,8,10,0,4,1,0,0,23,1483,Y
Walsall 004A,E01010249,39,5,44,343,Y,29,18,0,27,14,6,1,95,246,Y
Walsall 004B,E01010250,22,1,23,927,Y,20,6,0,9,8,0,1,44,958,Y
Walsall 004C,E01010252,18,4,22,965,Y,7,13,0,10,5,2,0,37,1139,Y
Walsall 004D,E01010254,24,0,24,885,Y,4,7,1,17,2,1,0,32,1265,Y
Walsall 005A,E01010348,15,1,16,1171,Y,23,21,3,8,1,5,0,61,573,Y
Walsall 005B,E01010349,17,2,19,1059,Y,25,10,3,16,6,15,1,76,387,Y
Walsall 005C,E01010351,18,2,20,1025,Y,12,15,3,9,3,0,0,42,1014,Y
Walsall 005D,E01010352,4,2,6,1556,Y,11,18,0,12,3,0,0,44,958,Y
Walsall 006A,E01010284,39,0,39,449,Y,13,10,1,15,3,7,0,49,830,Y
Walsall 006B,E01010285,23,0,23,927,Y,9,22,1,12,9,49,0,102,202,Y
Walsall 006C,E01010286,38,0,38,475,Y,4,13,0,17,13,2,0,49,830,Y
Walsall 006D,E01010290,17,0,17,1137,Y,7,15,1,16,5,1,1,46,903,Y
Walsall 007A,E01010251,20,0,20,1025,Y,5,7,0,3,3,0,0,18,1572,Y
Walsall 007B,E01010253,15,1,16,1171,Y,6,4,0,28,1,11,0,50,805,Y
Walsall 007C,E01010255,6,0,6,1556,Y,6,4,0,4,4,0,0,18,1572,Y
Walsall 007D,E01010256,10,1,11,1355,Y,10,9,0,14,3,10,2,48,858,Y
Walsall 007E,E01010257,6,0,6,1556,Y,8,5,0,5,2,0,0,20,1545,Y
Walsall 008A,E01010292,70,5,75,88,Y,23,37,4,52,20,112,4,252,41,N
Walsall 008B,E01010294,33,3,36,529,Y,13,23,0,17,12,1,1,67,476,Y
Walsall 008C,E01010296,7,1,8,1484,Y,7,10,0,9,4,6,1,37,1139,Y
Walsall 008D,E01010297,4,1,5,1592,Y,20,7,0,2,5,1,0,35,1190,Y
Walsall 009A,E01010291,21,2,23,927,Y,9,18,1,22,3,0,0,53,731,Y
Walsall 009B,E01010293,21,0,21,989,Y,11,17,0,17,4,0,0,49,830,Y
Walsall 009C,E01010298,23,2,25,848,Y,18,13,0,8,5,2,0,46,903,Y
Walsall 009D,E01010299,26,2,28,751,Y,6,8,1,7,6,0,0,28,1373,Y
Walsall 009E,E01010300,31,0,31,655,Y,16,13,0,23,11,17,0,80,344,Y
Walsall 010A,E01010319,10,0,10,1405,Y,7,10,0,5,7,0,1,30,1319,Y
Walsall 010B,E01010321,23,1,24,885,Y,12,9,1,14,8,2,2,48,858,Y
Walsall 010C,E01010353,23,1,24,885,Y,10,15,0,20,9,0,0,54,704,Y
Walsall 010D,E01010354,10,2,12,1319,Y,11,8,2,17,7,43,0,88,277,Y
Walsall 011A,E01010395,5,1,6,1556,Y,8,15,0,9,2,7,0,41,1044,Y
Walsall 011B,E01010397,38,2,40,425,Y,9,20,0,42,4,0,1,76,387,Y
Walsall 011C,E01010398,5,0,5,1592,Y,24,11,1,4,3,7,0,50,805,Y
Walsall 011D,E01010399,9,1,10,1405,Y,4,10,0,3,1,0,0,18,1572,Y
Walsall 012A,E01010282,33,8,41,405,Y,6,10,1,28,44,10,0,99,224,Y
Walsall 012B,E01010287,20,0,20,1025,Y,14,27,1,13,9,66,2,132,134,Y
Walsall 012C,E01010288,38,2,40,425,Y,9,9,0,35,7,0,0,60,594,Y
Walsall 012D,E01010289,35,0,35,554,Y,10,10,0,31,7,0,1,59,618,Y
Walsall 013B,E01010277,44,1,45,328,Y,13,26,2,25,12,0,0,78,356,Y
Walsall 013D,E01010283,39,2,41,405,Y,18,5,0,54,10,8,0,95,246,Y
Walsall 013E,E01032889,68,3,71,99,Y,20,16,4,37,10,0,0,87,286,Y
Walsall 014A,E01010393,11,0,11,1355,Y,5,13,0,4,1,0,0,23,1483,Y
Walsall 014B,E01010394,10,1,11,1355,Y,4,2,0,9,2,1,0,18,1572,Y
Walsall 014C,E01010396,19,3,22,965,Y,12,8,2,26,5,12,0,65,504,Y
Walsall 014D,E01010400,72,2,74,93,Y,14,22,3,36,34,46,1,156,100,Y
Walsall 015A,E01010241,35,2,37,496,Y,33,26,0,24,42,24,7,156,100,Y
Walsall 015B,E01010242,15,0,15,1217,Y,7,3,2,11,8,0,0,31,1290,Y
Walsall 015C,E01010243,15,1,16,1171,Y,13,8,0,11,4,1,0,37,1139,Y
Walsall 015D,E01010244,25,2,27,781,Y,13,18,0,6,6,1,0,44,958,Y
Walsall 016A,E01010320,26,0,26,817,Y,14,7,0,7,6,0,0,34,1219,Y
Walsall 016B,E01010322,20,1,21,989,Y,18,17,1,7,8,3,0,54,704,Y
Walsall 016C,E01010323,11,1,12,1319,Y,12,9,0,7,5,0,0,33,1242,Y
Walsall 016D,E01010324,22,2,24,885,Y,13,25,1,14,5,7,0,65,504,Y
Walsall 017A,E01010271,35,2,37,496,Y,23,41,0,21,14,0,0,99,224,Y
Walsall 017B,E01010272,22,2,24,885,Y,15,16,3,23,10,8,0,75,400,Y
Walsall 017C,E01010273,34,2,36,529,Y,11,17,1,16,12,0,1,58,635,Y
Walsall 017D,E01010295,23,1,24,885,Y,12,2,2,16,8,0,0,40,1076,Y
Walsall 018B,E01010279,35,0,35,554,Y,9,8,0,16,8,0,0,41,1044,Y
Walsall 018D,E01010374,67,2,69,107,Y,20,23,1,27,6,0,0,77,371,Y
Walsall 018E,E01010375,52,3,55,202,Y,20,24,1,38,11,5,1,100,211,Y
Walsall 018F,E01032888,53,1,54,212,Y,19,5,2,28,12,0,1,67,476,Y
Walsall 019A,E01010378,24,0,24,885,Y,9,15,2,13,4,3,0,46,903,Y
Walsall 019B,E01010379,9,0,9,1445,Y,10,13,0,10,3,0,0,36,1162,Y
Walsall 019C,E01010382,29,2,31,655,Y,8,15,2,13,2,0,1,41,1044,Y
Walsall 019D,E01010383,35,1,36,529,Y,11,23,1,23,9,0,0,67,476,Y
Walsall 020A,E01010376,1,0,1,1685,Y,13,5,1,1,1,0,0,21,1531,Y
Walsall 020B,E01010377,23,1,24,885,Y,21,20,3,19,12,2,0,77,371,Y
Walsall 020C,E01010380,12,0,12,1319,Y,20,11,0,6,7,0,0,44,958,Y
Walsall 020D,E01010381,33,2,35,554,Y,27,9,2,17,14,8,2,79,349,Y
Walsall 021A,E01010267,15,2,17,1137,Y,6,18,1,5,11,21,0,62,554,Y
Walsall 021B,E01010268,42,3,45,328,Y,9,29,1,35,9,88,0,171,81,Y
Walsall 021C,E01010274,24,1,25,848,Y,3,10,0,17,7,4,0,41,1044,Y
Walsall 021D,E01010275,42,1,43,361,Y,10,10,1,29,4,0,1,55,681,Y
Walsall 022A,E01010245,11,0,11,1355,Y,15,8,0,6,2,0,0,31,1290,Y
Walsall 022B,E01010246,11,1,12,1319,Y,11,27,0,8,11,0,1,58,635,Y
Walsall 022C,E01010247,13,1,14,1251,Y,14,6,1,3,6,6,0,36,1162,Y
Walsall 022D,E01010248,9,0,9,1445,Y,18,17,0,4,4,0,0,43,992,Y
Walsall 022E,E01010388,5,0,5,1592,Y,15,10,0,2,39,8,0,74,414,Y
Walsall 023A,E01010258,32,0,32,621,Y,17,20,3,21,3,3,1,68,469,Y
Walsall 023B,E01010259,18,0,18,1103,Y,4,11,0,14,2,0,0,31,1290,Y
Walsall 023C,E01010260,23,3,26,817,Y,7,22,1,12,7,0,0,49,830,Y
Walsall 023D,E01010266,30,0,30,686,Y,5,17,0,16,6,0,0,44,958,Y
Walsall 024A,E01010317,13,0,13,1288,Y,18,16,0,9,6,2,1,52,757,Y
Walsall 024B,E01010318,46,3,49,269,Y,17,24,1,27,14,0,4,87,286,Y
Walsall 024C,E01010325,18,1,19,1059,Y,16,26,1,11,5,1,0,60,594,Y
Walsall 024D,E01010369,89,2,91,44,Y,30,23,4,27,26,46,9,165,89,Y
Walsall 025A,E01010401,18,1,19,1059,Y,12,12,1,15,12,0,1,53,731,Y
Walsall 025B,E01010403,57,2,59,169,Y,19,23,4,25,5,3,0,79,349,Y
Walsall 025C,E01010404,61,7,68,110,Y,21,39,6,25,10,0,1,102,202,Y
Walsall 025D,E01010407,28,2,30,686,Y,12,15,3,16,7,0,0,53,731,Y
Walsall 025E,E01010408,27,6,33,596,Y,20,20,4,16,14,1,0,75,400,Y
Walsall 026A,E01010269,34,3,37,496,Y,8,9,0,13,7,0,1,38,1115,Y
Walsall 026B,E01010270,24,0,24,885,Y,14,27,1,15,8,0,0,65,504,Y
Walsall 026C,E01010362,47,0,47,291,Y,13,27,2,16,30,8,2,98,232,Y
Walsall 026D,E01010363,103,10,113,22,N,37,50,14,50,29,54,2,236,48,N
Walsall 027A,E01010402,32,6,38,475,Y,12,18,1,16,34,20,1,102,202,Y
Walsall 027B,E01010405,48,1,49,269,Y,26,42,15,25,19,36,0,163,91,Y
Walsall 027C,E01010406,97,4,101,31,N,66,48,20,58,78,91,7,368,19,N
Walsall 027D,E01010409,43,1,44,343,Y,16,12,1,18,8,0,0,55,681,Y
Walsall 028A,E01010385,5,0,5,1592,Y,10,7,0,7,3,0,0,27,1397,Y
Walsall 028B,E01010386,8,1,9,1445,Y,8,8,0,3,3,7,1,30,1319,Y
Walsall 028C,E01010387,5,1,6,1556,Y,11,7,0,6,0,0,0,24,1462,Y
Walsall 028D,E01010392,5,2,7,1518,Y,10,7,0,4,5,0,0,26,1420,Y
Walsall 029A,E01010326,11,0,11,1355,Y,29,16,0,9,5,7,0,66,490,Y
Walsall 029B,E01010327,22,1,23,927,Y,10,8,0,7,6,0,1,32,1265,Y
Walsall 029C,E01010328,4,2,6,1556,Y,20,11,0,5,1,0,0,37,1139,Y
Walsall 029D,E01010330,19,5,24,885,Y,30,22,2,12,13,0,0,79,349,Y
Walsall 030A,E01010368,341,27,368,5,N,63,46,30,91,138,500,68,936,5,N
Walsall 030B,E01010370,50,3,53,217,Y,28,21,2,25,34,3,0,113,179,Y
Walsall 030C,E01010371,162,26,188,11,N,62,33,4,52,57,245,29,482,10,N
Walsall 030D,E01010372,37,6,43,361,Y,15,20,0,18,6,1,0,60,594,Y
Walsall 030E,E01010373,27,1,28,751,Y,21,35,0,9,9,0,0,74,414,Y
Walsall 031A,E01010361,28,1,29,716,Y,17,9,0,5,6,0,0,37,1139,Y
Walsall 031B,E01010364,43,0,43,361,Y,11,12,1,22,6,0,1,53,731,Y
Walsall 031C,E01010365,53,2,55,202,Y,18,28,2,29,50,12,9,148,110,Y
Walsall 031D,E01010366,32,3,35,554,Y,12,19,1,14,8,1,0,55,681,Y
Walsall 031E,E01010367,39,3,42,391,Y,13,28,2,23,9,0,0,75,400,Y
Walsall 032A,E01010384,5,0,5,1592,Y,11,10,0,2,1,0,0,24,1462,Y
Walsall 032B,E01010389,14,2,16,1171,Y,9,13,0,4,32,1,0,59,618,Y
Walsall 032C,E01010390,6,0,6,1556,Y,10,7,2,4,1,0,1,25,1442,Y
Walsall 032D,E01010391,8,2,10,1405,Y,9,5,0,5,1,2,0,22,1509,Y
Walsall 033A,E01010261,30,2,32,621,Y,21,40,2,21,10,3,5,102,202,Y
Walsall 033B,E01010263,49,7,56,191,Y,9,21,12,27,16,69,8,162,95,Y
Walsall 033C,E01010264,33,5,38,475,Y,15,23,4,37,12,0,0,91,263,Y
Walsall 033D,E01010265,45,2,47,291,Y,20,36,1,16,20,6,1,100,211,Y
Walsall 034A,E01010336,35,3,38,475,Y,22,26,1,16,9,15,1,90,269,Y
Walsall 034B,E01010340,38,6,44,343,Y,15,15,2,13,8,3,2,58,635,Y
Walsall 034C,E01010341,28,1,29,716,Y,11,9,0,19,3,1,0,43,992,Y
Walsall 034D,E01010342,34,0,34,584,Y,12,10,0,15,4,2,1,44,958,Y
Walsall 034E,E01010343,30,6,36,529,Y,6,5,1,11,4,0,2,29,1346,Y
Walsall 034F,E01010344,22,1,23,927,Y,20,13,1,16,7,0,0,57,656,Y
Walsall 035A,E01010331,4,0,4,1626,Y,12,12,1,3,0,0,0,28,1373,Y
Walsall 035B,E01010332,11,3,14,1251,Y,15,27,0,4,7,0,0,53,731,Y
Walsall 035C,E01010333,12,5,17,1137,Y,17,20,1,3,3,3,2,49,830,Y
Walsall 035D,E01010334,17,0,17,1137,Y,25,13,0,6,6,0,0,50,805,Y
Walsall 036A,E01010262,29,1,30,686,Y,9,10,0,13,4,1,0,37,1139,Y
Walsall 036B,E01010309,45,1,46,311,Y,14,16,2,36,6,1,0,75,400,Y
Walsall 036C,E01010311,47,3,50,257,Y,26,27,1,30,15,1,0,100,211,Y
Walsall 036D,E01010316,45,0,45,328,Y,9,9,1,24,5,6,0,54,704,Y
Walsall 037A,E01010335,30,1,31,655,Y,15,14,1,17,11,1,0,59,618,Y
Walsall 037B,E01010337,17,2,19,1059,Y,14,14,0,10,9,0,0,47,883,Y
Walsall 037C,E01010338,20,8,28,751,Y,11,10,0,16,2,28,0,67,476,Y
Walsall 037D,E01010339,13,1,14,1251,Y,19,10,0,4,5,0,0,38,1115,Y
Walsall 038A,E01010310,33,0,33,596,Y,8,13,1,20,9,0,0,51,782,Y
Walsall 038B,E01010312,39,4,43,361,Y,6,11,3,25,16,2,0,63,538,Y
Walsall 038C,E01010313,7,1,8,1484,Y,5,13,0,18,11,0,0,47,883,Y
Walsall 038D,E01010314,22,0,22,965,Y,14,24,1,19,3,4,1,66,490,Y
Walsall 038E,E01010315,20,3,23,927,Y,12,37,1,30,15,2,0,97,238,Y
Walsall 039A,E01010329,9,0,9,1445,Y,10,8,0,6,3,14,1,42,1014,Y
Walsall 039B,E01010355,5,0,5,1592,Y,5,6,0,1,1,0,0,13,1649,Y
Walsall 039C,E01010356,8,0,8,1484,Y,17,9,0,8,7,0,0,41,1044,Y
Walsall 039D,E01010357,15,0,15,1217,Y,16,23,0,6,3,0,0,48,858,Y
Walsall 039E,E01010358,12,2,14,1251,Y,16,5,0,7,5,4,1,38,1115,Y
Walsall 039F,E01010359,20,0,20,1025,Y,8,5,0,9,1,0,0,23,1483,Y
Walsall 039G,E01010360,10,2,12,1319,Y,15,8,0,8,4,8,0,43,992,Y
Warwick 001A,E01031254,1,0,1,1685,Y,0,0,0,0,0,0,0,0,1708,Y
Warwick 004C,E01031283,0,0,0,1693,Y,1,0,0,0,0,0,0,1,1698,Y
Warwick 005G,E01031308,7,0,7,1518,Y,1,1,1,1,4,0,0,8,1678,Y
Wolverhampton 001A,E01010434,24,2,26,817,Y,7,6,3,14,5,25,0,60,594,Y
Wolverhampton 001B,E01010436,8,1,9,1445,Y,16,11,3,3,2,0,0,35,1190,Y
Wolverhampton 001C,E01010437,2,0,2,1666,Y,16,8,1,1,2,0,0,28,1373,Y
Wolverhampton 001D,E01010438,7,0,7,1518,Y,7,3,0,1,1,0,0,12,1656,Y
Wolverhampton 001E,E01010439,32,0,32,621,Y,7,4,2,8,11,0,0,32,1265,Y
Wolverhampton 001F,E01010440,34,2,36,529,Y,8,5,0,20,6,12,0,51,782,Y
Wolverhampton 001G,E01010441,16,0,16,1171,Y,4,3,4,7,5,0,0,23,1483,Y
Wolverhampton 002A,E01010495,25,0,25,848,Y,10,14,2,14,31,0,0,71,436,Y
Wolverhampton 002B,E01010497,7,2,9,1445,Y,7,4,0,5,2,0,0,18,1572,Y
Wolverhampton 002C,E01010499,18,1,19,1059,Y,6,7,2,7,1,27,0,50,805,Y
Wolverhampton 002D,E01010500,34,1,35,554,Y,17,6,5,19,3,0,1,51,782,Y
Wolverhampton 003A,E01010496,25,6,31,655,Y,9,8,2,9,8,21,2,59,618,Y
Wolverhampton 003B,E01010498,12,0,12,1319,Y,2,9,0,3,3,0,0,17,1593,Y
Wolverhampton 003C,E01010541,31,8,39,449,Y,3,5,1,16,4,0,0,29,1346,Y
Wolverhampton 003D,E01010543,15,3,18,1103,Y,6,1,2,16,6,0,0,31,1290,Y
Wolverhampton 004A,E01010456,34,1,35,554,Y,7,2,2,16,3,0,0,30,1319,Y
Wolverhampton 004B,E01010457,20,6,26,817,Y,14,13,3,20,7,8,1,66,490,Y
Wolverhampton 004C,E01010462,21,2,23,927,Y,12,9,4,22,6,1,0,54,704,Y
Wolverhampton 004D,E01010481,46,1,47,291,Y,10,8,3,21,7,1,0,50,805,Y
Wolverhampton 005A,E01010555,39,5,44,343,Y,6,5,0,17,4,0,1,33,1242,Y
Wolverhampton 005B,E01010556,12,0,12,1319,Y,3,10,0,9,5,0,0,27,1397,Y
Wolverhampton 005C,E01010557,8,1,9,1445,Y,6,16,0,6,2,0,0,30,1319,Y
Wolverhampton 005D,E01010559,28,0,28,751,Y,3,5,0,11,2,38,0,59,618,Y
Wolverhampton 005E,E01010560,12,0,12,1319,Y,6,10,0,7,4,0,0,27,1397,Y
Wolverhampton 006A,E01010435,27,0,27,781,Y,11,9,1,7,7,6,0,41,1044,Y
Wolverhampton 006B,E01010501,24,0,24,885,Y,19,4,2,7,0,0,0,32,1265,Y
Wolverhampton 006C,E01010502,13,6,19,1059,Y,6,12,1,8,5,27,0,59,618,Y
Wolverhampton 006D,E01010503,21,0,21,989,Y,13,6,2,17,9,15,0,62,554,Y
Wolverhampton 007A,E01010482,40,1,41,405,Y,5,5,1,6,8,0,0,25,1442,Y
Wolverhampton 007B,E01010483,44,4,48,276,Y,10,7,6,14,9,18,1,65,504,Y
Wolverhampton 007C,E01010484,21,0,21,989,Y,4,9,6,10,3,1,0,33,1242,Y
Wolverhampton 007D,E01010485,40,1,41,405,Y,11,5,1,24,8,0,1,50,805,Y
Wolverhampton 008A,E01010458,25,1,26,817,Y,11,13,1,19,3,0,0,47,883,Y
Wolverhampton 008B,E01010459,16,3,19,1059,Y,18,5,1,9,13,36,0,82,330,Y
Wolverhampton 008C,E01010460,7,1,8,1484,Y,5,2,0,5,1,0,0,13,1649,Y
Wolverhampton 008D,E01010461,15,1,16,1171,Y,18,9,2,9,1,0,0,39,1104,Y
Wolverhampton 008E,E01010566,16,2,18,1103,Y,7,15,1,3,2,0,0,28,1373,Y
Wolverhampton 009A,E01010539,27,0,27,781,Y,12,4,0,7,5,34,0,62,554,Y
Wolverhampton 009B,E01010540,21,0,21,989,Y,26,7,1,5,6,0,0,45,929,Y
Wolverhampton 009C,E01010542,21,0,21,989,Y,6,3,2,6,5,0,0,22,1509,Y
Wolverhampton 009D,E01010544,14,1,15,1217,Y,14,4,1,9,10,0,0,38,1115,Y
Wolverhampton 009E,E01010545,15,1,16,1171,Y,17,9,4,5,2,13,0,50,805,Y
Wolverhampton 010A,E01010554,23,2,25,848,Y,13,10,1,4,5,0,0,33,1242,Y
Wolverhampton 010B,E01010558,12,0,12,1319,Y,8,14,1,5,1,0,0,29,1346,Y
Wolverhampton 010C,E01010562,27,0,27,781,Y,8,7,0,13,1,0,0,29,1346,Y
Wolverhampton 010D,E01010563,22,0,22,965,Y,14,10,1,11,3,20,0,59,618,Y
Wolverhampton 010E,E01010567,27,3,30,686,Y,12,4,0,11,17,10,1,55,681,Y
Wolverhampton 011A,E01010478,60,3,63,150,Y,20,9,0,15,11,0,0,55,681,Y
Wolverhampton 011B,E01010479,19,2,21,989,Y,8,9,1,7,2,8,1,36,1162,Y
Wolverhampton 011C,E01010480,22,3,25,848,Y,16,8,1,14,5,15,2,61,573,Y
Wolverhampton 011D,E01010486,49,0,49,269,Y,8,10,2,16,6,0,0,42,1014,Y
Wolverhampton 012A,E01010474,36,3,39,449,Y,22,22,1,23,1,1,0,70,445,Y
Wolverhampton 012B,E01010561,6,0,6,1556,Y,11,13,0,5,2,0,0,31,1290,Y
Wolverhampton 012C,E01010564,106,13,119,20,N,65,88,16,74,106,292,8,649,8,N
Wolverhampton 012D,E01010565,8,0,8,1484,Y,7,9,0,3,4,2,0,25,1442,Y
Wolverhampton 013A,E01010522,47,6,53,217,Y,13,22,2,26,17,6,1,87,286,Y
Wolverhampton 013B,E01010523,62,5,67,116,Y,18,11,4,26,5,3,2,69,456,Y
Wolverhampton 013C,E01010524,47,3,50,257,Y,6,7,0,16,6,0,1,36,1162,Y
Wolverhampton 013D,E01010525,41,1,42,391,Y,6,12,0,16,4,0,0,38,1115,Y
Wolverhampton 014A,E01010546,8,0,8,1484,Y,10,7,0,1,3,0,0,21,1531,Y
Wolverhampton 014B,E01010547,16,0,16,1171,Y,16,13,1,4,5,17,0,56,668,Y
Wolverhampton 014C,E01010548,11,0,11,1355,Y,4,2,0,2,0,0,0,8,1678,Y
Wolverhampton 014D,E01010549,21,0,21,989,Y,5,2,0,4,0,21,0,32,1265,Y
Wolverhampton 014E,E01010553,16,0,16,1171,Y,5,6,1,1,5,0,0,18,1572,Y
Wolverhampton 015A,E01010471,56,3,59,169,Y,14,10,1,21,15,0,1,62,554,Y
Wolverhampton 015B,E01010472,50,2,52,232,Y,15,21,5,25,11,0,1,78,356,Y
Wolverhampton 015C,E01010473,50,3,53,217,Y,15,10,5,20,17,67,1,135,126,Y
Wolverhampton 015D,E01010475,12,0,12,1319,Y,17,19,1,9,2,1,1,50,805,Y
Wolverhampton 015E,E01010476,75,1,76,80,Y,20,14,10,29,23,1,3,100,211,Y
Wolverhampton 015F,E01010477,27,1,28,751,Y,7,9,0,17,6,12,1,52,757,Y
Wolverhampton 016A,E01010526,53,3,56,191,Y,15,14,0,29,8,3,1,70,445,Y
Wolverhampton 016B,E01010527,41,8,49,269,Y,6,11,4,19,10,6,5,61,573,Y
Wolverhampton 016C,E01010528,38,3,41,405,Y,12,8,7,10,22,134,5,198,65,Y
Wolverhampton 016D,E01010529,56,8,64,142,Y,13,8,1,15,16,0,1,54,704,Y
Wolverhampton 017A,E01010506,48,5,53,217,Y,17,14,3,19,16,0,0,69,456,Y
Wolverhampton 017B,E01010508,66,9,75,88,Y,26,26,14,31,14,12,2,125,153,Y
Wolverhampton 017C,E01010510,23,3,26,817,Y,17,13,4,6,6,0,0,46,903,Y
Wolverhampton 017D,E01010511,72,8,80,65,Y,18,16,3,21,5,0,1,64,521,Y
Wolverhampton 017E,E01010512,12,2,14,1251,Y,8,4,0,5,19,4,0,40,1076,Y
Wolverhampton 018A,E01010442,44,8,52,232,Y,24,11,1,11,15,1,2,65,504,Y
Wolverhampton 018B,E01010443,49,4,53,217,Y,40,13,6,25,13,22,2,121,159,Y
Wolverhampton 018C,E01010444,10,0,10,1405,Y,12,7,2,3,3,0,0,27,1397,Y
Wolverhampton 018D,E01010445,36,1,37,496,Y,11,14,1,26,1,0,0,53,731,Y
Wolverhampton 018E,E01010447,27,2,29,716,Y,18,3,0,20,5,1,0,47,883,Y
Wolverhampton 018F,E01010448,43,4,47,291,Y,7,14,0,13,11,0,0,45,929,Y
Wolverhampton 019A,E01010509,15,2,17,1137,Y,4,1,1,8,2,0,1,17,1593,Y
Wolverhampton 019B,E01010550,5,0,5,1592,Y,10,13,0,3,4,0,0,30,1319,Y
Wolverhampton 019C,E01010551,8,0,8,1484,Y,6,5,0,6,11,10,0,38,1115,Y
Wolverhampton 019D,E01010552,16,1,17,1137,Y,0,3,1,8,2,1,0,15,1627,Y
Wolverhampton 020A,E01010463,61,3,64,142,Y,21,8,2,18,9,1,1,60,594,Y
Wolverhampton 020B,E01010464,63,8,71,99,Y,18,18,23,11,29,46,2,147,113,N
Wolverhampton 020C,E01010465,33,0,33,596,Y,16,9,5,14,7,1,0,52,757,Y
Wolverhampton 020D,E01010466,45,2,47,291,Y,20,3,1,10,10,1,0,45,929,Y
Wolverhampton 020E,E01010470,38,3,41,405,Y,6,7,1,15,7,0,0,36,1162,Y
Wolverhampton 020F,E01010521,600,48,648,1,N,96,78,70,164,190,620,88,1306,3,N
Wolverhampton 021A,E01010487,8,1,9,1445,Y,8,6,1,1,0,0,0,16,1608,Y
Wolverhampton 021B,E01010488,14,0,14,1251,Y,5,3,2,5,7,0,0,22,1509,Y
Wolverhampton 021C,E01010493,12,3,15,1217,Y,6,6,1,5,1,0,0,19,1563,Y
Wolverhampton 021D,E01010504,17,0,17,1137,Y,7,4,8,7,7,0,0,33,1242,Y
Wolverhampton 021E,E01010505,12,4,16,1171,Y,6,6,1,4,4,9,2,32,1265,Y
Wolverhampton 021F,E01010507,3,3,6,1556,Y,10,5,2,2,5,8,2,34,1219,Y
Wolverhampton 022A,E01010418,8,2,10,1405,Y,10,11,1,1,13,1,0,37,1139,Y
Wolverhampton 022B,E01010421,38,1,39,449,Y,7,6,3,17,4,27,1,65,504,Y
Wolverhampton 022C,E01010423,30,1,31,655,Y,18,9,1,12,7,0,0,47,883,Y
Wolverhampton 022D,E01010424,26,3,29,716,Y,13,6,1,4,4,0,0,28,1373,Y
Wolverhampton 023A,E01010417,23,0,23,927,Y,10,12,0,18,10,0,0,50,805,Y
Wolverhampton 023B,E01010419,16,4,20,1025,Y,17,7,1,15,5,7,0,52,757,Y
Wolverhampton 023C,E01010420,35,0,35,554,Y,26,9,4,12,26,99,1,177,77,Y
Wolverhampton 023D,E01010425,30,1,31,655,Y,10,13,0,11,13,0,0,47,883,Y
Wolverhampton 023E,E01010446,47,4,51,248,Y,18,16,2,15,32,1,1,85,305,Y
Wolverhampton 026A,E01010467,55,2,57,184,Y,15,4,2,7,8,4,0,40,1076,Y
Wolverhampton 026B,E01010468,40,0,40,425,Y,10,7,0,4,3,3,2,29,1346,Y
Wolverhampton 026C,E01010469,10,1,11,1355,Y,5,1,1,8,2,1,0,18,1572,Y
Wolverhampton 026D,E01010516,11,0,11,1355,Y,2,2,0,2,4,0,0,10,1670,N
Wolverhampton 026E,E01010518,18,2,20,1025,Y,7,4,0,3,5,0,1,20,1545,Y
Wolverhampton 027A,E01010414,89,13,102,29,Y,84,75,10,88,44,38,15,354,24,N
Wolverhampton 027B,E01010415,34,5,39,449,Y,10,6,2,18,7,1,0,44,958,Y
Wolverhampton 027C,E01010416,54,1,55,202,Y,22,8,0,14,5,0,1,50,805,Y
Wolverhampton 027D,E01010422,18,4,22,965,Y,26,31,2,24,15,1,3,102,202,Y
Wolverhampton 028A,E01010489,27,1,28,751,Y,5,8,1,5,2,14,1,36,1162,Y
Wolverhampton 028B,E01010490,42,1,43,361,Y,4,3,1,9,12,0,0,29,1346,Y
Wolverhampton 028C,E01010491,21,0,21,989,Y,12,7,2,7,5,34,1,68,469,Y
Wolverhampton 028D,E01010492,3,0,3,1651,Y,1,4,0,3,4,0,0,12,1656,Y
Wolverhampton 028E,E01010494,9,0,9,1445,Y,6,2,0,2,2,0,0,12,1656,Y
Wolverhampton 029A,E01010449,44,3,47,291,Y,12,11,0,23,5,2,0,53,731,Y
Wolverhampton 029B,E01010450,92,6,98,32,Y,26,26,9,31,42,12,5,151,106,Y
Wolverhampton 029C,E01010451,27,2,29,716,Y,56,70,2,17,20,72,1,238,46,N
Wolverhampton 029D,E01010452,26,2,28,751,Y,8,7,2,14,6,3,0,40,1076,Y
Wolverhampton 029E,E01010455,53,3,56,191,Y,27,15,1,18,12,0,1,74,414,Y
Wolverhampton 030A,E01010427,36,0,36,529,Y,16,10,1,11,8,17,1,64,521,Y
Wolverhampton 030B,E01010431,17,0,17,1137,Y,6,4,0,1,3,0,0,14,1634,Y
Wolverhampton 030C,E01010432,14,0,14,1251,Y,11,9,1,5,1,0,0,27,1397,Y
Wolverhampton 030D,E01010519,22,0,22,965,Y,8,6,0,5,5,0,0,24,1462,Y
Wolverhampton 030E,E01010520,18,0,18,1103,Y,4,10,1,4,2,0,0,21,1531,Y
Wolverhampton 031A,E01010513,52,1,53,217,Y,10,3,0,15,6,1,0,35,1190,Y
Wolverhampton 031B,E01010514,6,0,6,1556,Y,6,3,0,7,0,0,0,16,1608,Y
Wolverhampton 031C,E01010515,13,0,13,1288,Y,2,8,0,0,1,0,0,11,1665,Y
Wolverhampton 031D,E01010517,13,0,13,1288,Y,9,4,0,8,3,0,0,24,1462,Y
Wolverhampton 032A,E01010533,27,2,29,716,Y,10,5,3,9,8,0,0,35,1190,Y
Wolverhampton 032B,E01010535,33,2,35,554,Y,21,15,3,17,11,0,0,67,476,Y
Wolverhampton 032C,E01010536,7,0,7,1518,Y,7,9,1,7,1,0,0,25,1442,Y
Wolverhampton 032D,E01010537,9,1,10,1405,Y,3,8,0,2,1,0,1,15,1627,Y
Wolverhampton 033A,E01010410,48,8,56,191,Y,46,72,10,50,54,38,6,276,35,N
Wolverhampton 033B,E01010411,24,2,26,817,Y,14,15,2,19,3,0,1,54,704,Y
Wolverhampton 033C,E01010412,55,2,57,184,Y,23,53,1,55,7,0,0,139,120,Y
Wolverhampton 033D,E01010413,27,1,28,751,Y,15,20,3,23,5,11,0,77,371,Y
Wolverhampton 034A,E01010531,43,4,47,291,Y,25,25,4,26,10,0,1,91,263,Y
Wolverhampton 034B,E01010532,12,1,13,1288,Y,5,12,2,12,3,0,0,34,1219,Y
Wolverhampton 034C,E01010534,11,3,14,1251,Y,8,3,0,5,0,0,0,16,1608,Y
Wolverhampton 034D,E01010538,26,2,28,751,Y,9,6,0,13,2,0,0,30,1319,Y
Wolverhampton 035A,E01010426,28,3,31,655,Y,26,22,2,9,19,22,0,100,211,Y
Wolverhampton 035B,E01010428,51,1,52,232,Y,16,4,2,8,9,2,0,41,1044,Y
Wolverhampton 035C,E01010429,19,0,19,1059,Y,10,6,0,10,5,1,1,33,1242,Y
Wolverhampton 035D,E01010430,58,3,61,159,Y,18,5,1,24,5,0,0,53,731,Y
Wolverhampton 035E,E01010433,48,4,52,232,Y,22,28,4,21,20,3,1,99,224,Y
Wolverhampton 035F,E01010453,40,6,46,311,Y,12,14,3,19,13,26,0,87,286,Y
Wolverhampton 035G,E01010454,40,0,40,425,Y,11,7,1,9,7,1,0,36,1162,Y
Wolverhampton 035H,E01010530,62,5,67,116,Y,28,26,3,24,25,37,3,146,114,Y
